A.B.	EY B IY
AARONSBURG	AH R AA N S B AH R G
ABAC	AE B AH K
ABBOTSFORD	AE B AH T S F OW R D
ABBYVILLE	AE B AH V AH L
ABERFOYLE	AE B AH R F OY L
ABINGER	AH B IH N JH ER
ABITA	AE B AH T AH
ABITARE	AE B AH T AH R
ABRAIMS	AE B R EY M Z
ABSAROKEE	AE B S AH R AH K IY IY
ACACIO	AH K EY S IY OW
ACCOMAC	AE K AH M AH K
ACEQUIA	AH S EH K W IY AH
ACESS	EY S AH S
ACKWORTH	AE K W AH R TH
ACMAR	AE K M AH R
ACRA	AE K R AH
ACUSHNET	AH K AH SH N AH T
ACWORTH	AE K W AH R TH
ADAIRSVILLE	AE D AH AH R S V AH L
ADAIRVILLE	AE D AH AH R V AH L
ADALBERT	AH D AE L B AH R T
ADALISA	AH D AE L AH S AH
ADAMSBURG	AH D AE M Z AH R G
ADAMSVILLE	AH D AE M Z AH L
ADM	AE D M
ADMIN	AE D M IH N
ADMINIS	AE D M AH N AH S
ADOBES	AH D OW B IY Z
ADONA	AE D AH N AH
ADRIANNE	AE D R IY AH N
AFB	AE F B
AFFTON	AE F T AH N
AFLEX	AH F L EH K S
AFS	AE F S
AFTON	AE F T AH N
AGNESS	EY JH N AH S
AIEA	EY IY AH
AIMWELL	AH IH M W EH L
AIRE	AH AY ER
AIRPARK	AH IH R P AA R K
AIRPO	AE AH R P OW
AIRTRAIN	AH IH R T R EY N
AIRVILLE	AE AH R V AH L
AITKIN	EY T AH N
AKASKA	AH K AE S AH
AKELEY	AH K IY L IY
AKHIOK	AE K IY AH K
AKIACHAK	EY K IY AH CH AH K
AKIAK	EY K IY AH K
AKUTAN	AE K Y UW T AH N
ALAKANUK	AH L AE K AH N AH K
ALAMOGORDO	AE L AH M AH G AO R D OW
ALAMOTA	AH L AE M AH T AH
ALANSON	AH L AE N S AH N
ALAPAHA	AH L AE P AH HH AH
ALBERENE	AE L B AH R IY N
ALBERMARLE	AE L B AH R M AH R L
ALBERTON	AE L B AH R T AH N
ALBIA	AE L B IY AH
ALBORN	AE L B AH R N
ALBOURNE	AE L B OW R N
ALBURG	AE L B AH R G
ALBURNETT	AE L B AH R N AH T
ALBURTIS	AE L B AH R T AH S
ALCALDE	AE L K AH L D
ALCOLU	AE L K AH L UW
ALCOVA	AE L K AH V AH
ALDENE	AE L D IY N
ALDERBROOK	AE L D AH R B R AH K
ALDERWOOD	AE L D AH R W UW D
ALDIE	AE L D AY
ALDINE	AE L D AY N
ALECIA	AH L IY SH IY AH
ALEKNAGIK	AH L EH K N AH JH AH K
ALEPPO	AH L EH P OW
ALGONA	AE L G AH N AH
ALGONKIN	AE L G AO NG K AH N
ALGOOD	AE L G UW D
ALICEVILLE	AH L IH S AH V AH L
ALISO	AE L AH S OW
ALISTERVILLE	AE L AH S T AH R V AH L
ALKABO	AE L K AH B OW
ALKOL	AE L K AH L
ALLAKAKET	AE L AE K AH K AH T
ALLEDONIA	AE L AH D OW N Y AH
ALLEGAN	AE L AH G AH N
ALLEGANY	AE L EH G AH N IY
ALLEMANDS	AE L AH M AH N D Z
ALLENPORT	AO L AH N P OW R T
ALLENSPARK	AO L AH N S P AA R K
ALLENSTOWN	AO L AH N Z T AW N
ALLENSVILLE	AE L EH N S V AH L
ALLERMAN	AO L ER M AE N
ALLETTA	AE L EH T AH
ALLEYTON	AE L IY T AH N
ALLGAIR	AE L G AH AH R
ALLISONIA	AE L AH S OW N Y AH
ALLONS	AO L AO N Z
ALLOUEZ	AE L AW AH Z
ALLWOOD	AO L W UH D
ALMELO	AE L M AH L OW
ALMENA	AE L M AH N AH
ALMONESSON	AE L M AH N EH S AH N
ALMONT	AE L M AH N T
ALMYRA	AE L M AH R AH
ALOMA	AE L AH M AH
ALORTON	EY L ER T AH N
ALPENA	AE L P AH N AH
ALPLAUS	AE L P L EY AH S
ALSEA	AE L S IY AH
ALSTEAD	AE L S T IY D
ALSTYNE	AE L S T AY N
ALSWORTH	AE L S W AH R TH
ALTAMONTE	AE L T AH M AH N T
ALTHA	AE L TH AH
ALTHEIMER	AE L TH IY M AH R
ALTMAR	AE L T M AH R
ALTONA	AE L T AH N AH
ALTONAH	AE L T AH N AH
ALTRO	AE L T R OW
ALTURA	AE L T Y AH R AH
ALVADA	AE L V AH D AH
ALVATON	AE L V AH T AH N
ALVINE	AE L V AY N
ALVISO	AE L V AH S OW
ALVO	AE L V OW
ALVORDTON	AE L V AO R D T AH N
ALVY	AE L V IY
ALWICK	AE L W AH K
ALZADA	AE L Z AH D AH
AMA	AE M AH
AMAGON	AE M AH G AH N
AMANT	EY M AH N T
AMARON	AH M AA R AO N
AMAWALK	AE M AH AH K
AMBERLY	AE M B ER L IY
AMBIA	AE M B IY AH
AMEAGLE	EY M IY G AH L
AMENIA	AH M IY N Y AH
AMERSFORT	AH M AH R S AH R T
AMESBURY	AH M EH Z Y AH R IY
AMF	AE M F
AMHURST	AE M HH AH R S T
AMIRET	AE M AH R AH T
AMISSVILLE	AH M IH S V AH L
AMITE	AH M AY T
AMLIN	AE M L AH N
AMMA	AE M AH
AMORET	AE M AH R AH T
AMPERE	AE M P ER
AMPTHILL	AE M P TH AH L
AMSTEL	AE M S T AH L
AMSTON	AE M Z T AH N
ANABEL	AE N AH B AH L
ANACOCO	AH N AE K AH K OW
ANAKTUVUK	AE N AH K T Y UW V AH K
ANAMOOSE	AE N AH M UW Z
ANAMOSA	AH N AE M AH S AH
ANATONE	AE N AH T OW N
ANCHORVILLE	AE NG K AO R V AH L
ANCO	AE NG K OW
ANCRAM	AE NG K R AH M
ANCRAMDALE	AE NG K R AH M D EY L
ANDALE	AE N D EY L
ANDICE	AE N D AH S
ANDREASE	AE N D R IY Z
ANDROVETTE	AE N D R AH V EH T
ANELVE	AE N AH L V
ANETA	AE N AH T AH
ANETH	EY N AH TH
ANGELUS	AE N JH AH L AH S
ANGLESEA	AE NG G AH L S IY
ANGOON	AE N G UW N
ANGWIN	AE N G W AH N
ANIMAS	AE N AH M AH Z
ANIWA	AE N AH W AH
ANJALI	AE N JH AH L IY
ANKENER	AE NG K IY N AH R
ANNADA	AE N AH D AH
ANNADALE	AE N AH D EY L
ANNADLE	AE N AH D AH L
ANNAWAN	AE N AH AH N
ANNFIELD	AE N F IY L D
ANNONA	AE N AH N AH
ANNS	AE N Z
ANNVILLE	AE N V AH L
ANSTED	AE N Z T EH D
ANTIGO	AE N T AY G OW
ANTIMONY	AE N T IH M AO N IY
ANTIN	AE N T IH N
ANTONINO	AE N T AA N AH N OW
ANTONITO	AE N T AA N AH T OW
ANUTT	AE N AH T
ANVIK	AE N V AH K
APALACHIN	AH P AE L AH CH IH N
APISON	EY P IY Z AO N
APLINGTON	AE P L IH N G T AH N
APPAM	AE P AH M
APPET	AE P AH T
APPLEBEES	AE P AH L B IY Z
APPLETREE	AE P AH L T R IY
APPOMATTOX	AE P AH M AE T AH K S
APTOS	AE P T AA S
APTS	AE P T S
APTS.	AE P T S
AQUASCO	AE K W AA S OW
AQUILLA	AE K W IH L AH
AQUONE	AE K W OW N
ARABI	AE R AH B IY
ARBELA	AA R B AH L AH
ARBOLES	AA R B OW L Z
ARBON	AA R B AH N
ARBOVALE	AA R B AH V EY L
ARBUTUS	AA R B Y UW T AH S
ARBYRD	AA R B AH R D
ARCHDALE	AA R CH D EY L
ARCHWOOD	AA R CH W UH D
ARDALE	AA R D EY L
ARDARA	AA R D AH R AH
ARDO	AA R D OW
ARDOCH	AA R D AH CH
AREDALE	AH R IY D EY L
ARENZVILLE	AH R EH N Z AH L
ARGILE	AA R JH AH L
ARGILLITE	AA R JH AH L AY T
ARGONIA	AA R G OW N Y AH
ARGOS	AA R G AH Z
ARGUSVILLE	AA R G AH Z AH L
ARGYL	AA R JH AH L
ARIELLE	AH R IY L
ARIMO	AE R AH M OW
ARION	AE R IY AH N
ARITON	AE R AH T AH N
ARJAY	AA R JH EY IY
ARKANA	AA R K AH N AH
ARKANSAW	AA R K AE N S AH
ARKDALE	AA R K D EY L
ARKOMA	AA R K AH M AH
ARKPORT	AA R K AH R T
ARKVILLE	AA R K V AH L
ARLEE	AA R L IY IY
ARLEIGH	AA R L EY
ARLO	AA R L OW
ARMAGH	AA R M AH
ARMINTO	AA R M IH N T OW
ARMONA	AA R M AH N AH
ARMOREL	AA R M AH R AH L
ARMUCHEE	AA R M AH CH IY IY
ARNAUDVILLE	AA R N AO D AH L
ARNEGARD	AA R N AH G AH R D
ARNOLDSBURG	AA R N OW L D S B AH R G
ARNOLDSVILLE	AA R N OW L D S V AH L
ARNPRIOR	AA R N P R AY AH R
AROCK	AH R AA K
ARODA	AE R AH D AH
ARONA	AE R AH N AH
ARREY	AE R IY
ARRIBA	AE R AH B AH
ARTAS	AA R T AH Z
ARTESIA	AA R T IY ZH IY AH
ARVADA	AA R V AH D AH
ARVERNE	AA R V AH R N
ARVILLA	AA R V IH L AH
ARVONIA	AA R V OW N Y AH
ASCAN	AH S K AE N
ASCO	AE S OW
ASHAWAY	AE SH AH W EY
ASHBURNHAM	AE SH B ER N HH AE M
ASHCAMP	AE SH K AE M P
ASHERTON	AE SH ER T AH N
ASHFIELD	AE SH F IY L D
ASHKUM	AE SH AH M
ASHTABULA	AE SH T AH B Y UW L AH
ASHUELOT	AH Z HH Y UW L AA T
ASHWAUBENON	AE SH W AO B AH N AH N
ASKE	AE S
ASKOV	AE S AH V
ASOTIN	AE S AH T AH N
ASPERMONT	AE S AH R M AH N T
ASPERS	AE S AH R Z
ASSARIA	AE S AE R IY AH
ASSAWOMAN	AE S AH W UH M AH N
ASSER	AE S ER
ASSONET	AE S AH N AH T
ASTATULA	AE S T AH T Y UW L AH
ATALISSA	AE T AH L IH S AH
ATASCADERO	AE T AH S AE D AH R OW
ATASCOSA	AH T AE S AH S AH
ATGLEN	AE T G L AH N
ATHELSTANE	AE TH AH L S T EY N
ATHOL	AE TH AH L
ATLANTICARE	AE T L AE N T AH K AH R
ATMAUTLUAK	AE T M AH T L UW W AH K
ATMORE	AE T M AH R
ATOKA	AE T AH K AH
ATTAPULGUS	AE T AH P UH L G AH S
AUBURNDALE	AO B ER N D EY L
AUBURNTOWN	AO B ER N T AW N
AUDLEY	AO D L IY
AUGUSTINA	AH G AH S T AH N AH
AURELIA	AH R IY L Y AH
AUSABLE	AH Y UW S AH B AH L
AUSTERLITZ	AO S T AH R L AH T S
AUSTINBURG	AO S T IH N B AH R G
AUSTINS	AO S T AH N Z
AUSTINTOWN	AO S T AH N T OW N
AUSTINVILLE	AO S T IH N V AH L
AUSTONIO	AO S T OW N IY OW
AUTAUGAVILLE	AH T AO G AH V AH L
AUTH.	AO TH
AUTRYVILLE	AO T R AH V AH L
AUXVASSE	AO K S V AH S
AVANDALE	AH V AE N D EY L
AVE.	AA V EY
AVEAT	EY V IY T
AVENAL	AE V AH N AH L
AVES	AA V EY Z
AVFULTON	AE V F UH L T AH N
AVISTON	AH V IH Z T AH N
AVIVA	AH V IY V AH
AVOCA	AE V AH K AH
AVONMORE	AH V AA N M AH R
AWENDAW	AO EH N D AH
AWOSTING	AO AA S T AH NG
AXSON	AE K S AH N
AYCRIGG	EY K R AH G
AYDEN	EY D AH N
AYDLETT	EY D L AH T
AYLETT	EY L AH T
AYMAR	EY M AH R
AYNOR	EY N AH R
AYRSHIRE	EY AH R SH AY ER
AZLE	AE Z AH L
AZUSA	AH Z UW S AH
BACKIEL	B AE K IY L
BACKOO	B AE K UW
BACLIFF	B AE K L AH F
BACONTON	B EY K AH N T AH N
BAILEYTON	B EY L IY T AH N
BAILEYVILLE	B EY L EY V AH L
BAINVILLE	B EY N V AH L
BAIROIL	B AE AH R OY L
BAKERSTOWN	B EY K ER Z T AW N
BAKERSVILLE	B AH K AH R S V AH L
BAKERTON	B EY K ER T AH N
BALATON	B IY AH L AH T AH N
BALCONES	B IY AH L K OW N Z
BALDWINSVILLE	B AE L D W IH N S V AH L
BALDWINVILLE	B AE L D W IH N V AH L
BALDWYN	B AE L D W AH N
BALDY	B AO L D IY
BALLICO	B AE L AH K OW
BALLSTON	B AO L Z T AH N
BALLWIN	B AO L W IH N
BALLYS	B AO L IY Z
BALMORHEA	B AE L M AO R IY AH
BALTUSROL	B AE L T AH Z R AH L
BANDERA	B AE N D IH R AH
BANDON	B AE N D AA N
BANDYTOWN	B AE N D IY T AW N
BANEBERRY	B EY N B EH R IY
BANKBRIDGE	B AE NG K B R IH JH
BANTRY	B IY AH N T R IY
BANYER	B EY N IY ER
BARABOO	B AA R AH B UW
BARATARIA	B AE R AH T AE R IY AH
BARBADOES	B AA R B AH D OW Z
BARBERRY	B AA R B ER R IY
BARBEY	B AA R B IY IY
BARDONIA	B AA R D OW N Y AH
BARDSDALE	B AA R D Z D EY L
BARDSTOWN	B AA R D Z T AW N
BARGERSVILLE	B AA R JH AH R S V AH L
BARHAMSVILLE	B AH R AE M Z AH L
BARLING	B AA R L IH NG
BARNABUS	B AA R N AH B AH S
BARNARDSVILLE	B AA R N AA R D S V AH L
BARNEGAT	B AA R N AH G AH T
BARNESBORO	B AA R N EH Z AH R OW
BARNESVILLE	B AA R N EH Z AH L
BARNETTS	B AA R N EH T S
BARNEVELD	B AA R N AH V AH L D
BARNSDALE	B AA R N Z D EY L
BARNSDALL	B AA R N S D AH L
BARNSTABLE	B AA R N S T EY B AH L
BARNSTEAD	B AA R N S T EH D
BARODA	B AE R AH D AH
BARRANCA	B AE R AE NG K AH
BARREE	B AA R IY
BARRONETT	B AE R AH N AH T
BARRYMOR	B AE R AH M AH R
BARRYTON	B AA R IY T AH N
BARRYTOWN	B AA R IY T AW N
BARRYVILLE	B AE R AH V AH L
BARTELSO	B AA R T EH L S OW
BARTHOLDI	B AA R TH OW L D IY
BARTHOLF	B AA R TH OW L F
BARTHOLOMEWS	B AA R TH AH L AA M Y UW Z
BARTONSVILLE	B AA R T AA N S V AH L
BARTONVILLE	B AA R T AA N V AH L
BARWELL	B AA R W EH L
BASEHOR	B AE S AH AH R
BASILONE	B AE S AH L OW N
BASOM	B AE S AH M
BASSFIELD	B EY S F IY L D
BASTROP	B AE S T R AH P
BATCHTOWN	B AE CH T AW N
BATESBURG	B AH T EH Z AH R G
BATRE	B EY T AH R
BATSTO	B AE T S T OW
BATTLEBORO	B AE T L EH B AH R OW
BATTLEHILL	B AE T AH L HH IH L
BATTLETOWN	B AE T AH L T AW N
BATTLEVIEW	B AE T AH L V Y UW
BAUDETTE	B AH D EH T
BAUTIST	B EY Y UW T AH S T
BAVON	B AE V AH N
BAYBERRY	B EY B EH R IY
BAYBORO	B EY B AH R OW
BAYCHESTER	B EY CH EH S T ER
BAYCLIFF	B EY K L IH F
BAYFIELD	B EY F IY L D
BAYPORT	B EY P OW R T
BAYRIDGE	B EY R IH JH
BAYSHORE	B EY SH OW R
BAYSWATER	B EY Z W AO T ER
BAYVIEW	B EY V Y UW
BAYVILLE	B EY V AH L
BAYWATER	B EY W AO T ER
BAYWAY	B EY W EY
BAZINE	B AH Z AY N
BCH	B IY S IY
BDG	B IY D IY G
BEAC	B AH AE K
BEACHVIEW	B IY CH V Y UW
BEACHWOOD	B IY CH W UH D
BEADEL	B AH AE D AH L
BEALLSVILLE	B AH AE L S V AH L
BEARCREEK	B AE ER K R IY K
BEARFOOT	B AE ER F UH T
BEARSDALE	B AE ER Z D EY L
BEARVILLE	B AH AA R V AH L
BEAUME	B AH AO M
BEAVERCREEK	B IY V ER K R IY K
BEAVERDAM	B IY V ER D AE M
BEAVERLETT	B AH AH V AH R L AH T
BEAVERTOWN	B IY V ER T AW N
BEAVERVILLE	B AH AH V AH R V AH L
BECCARIA	B IH K AE R IY AH
BECHSTEIN	B IH CH S T IY N
BECKVILLE	B IH K V IH L
BEECHGROVE	B IY CH G R OW V
BEECHKNOLL	B IY CH N OW L
BEECHMONT	B AH EH CH M AH N T
BEEDEVILLE	B AH EH D AH V AH L
BEERSHEBA	B AH AH R SH AH B AH
BEEVILLE	B AH EH V AH L
BEJOU	B AH JH UW
BELCAMP	B EH L K AE M P
BELCHERTOWN	B EH L CH ER T AW N
BELDENVILLE	B IH L D EH N V AH L
BELEWS	B AH L UW Z
BELGROVE	B EH L G R OW V
BELHAVEN	B EH L HH EY V AH N
BELINGTON	B IY L IH NG T AH N
BELLAIR	B EH L EH R
BELLAIRE	B EH L AH AY ER
BELLBROOK	B EH L B R UH K
BELLEAIR	B EH L EH R
BELLEFONTAINE	B IH L EH F AH N T EY N
BELLERO	B IH L EH R OW
BELLEVIEW	B EH L V Y UW
BELLHAVEN	B EH L HH EY V AH N
BELLMAWR	B IH L M AO R
BELLMEAD	B EH L M IY D
BELLMEADE	B IH L M IY D
BELLONA	B IH L AA N AH
BELLPORT	B EH L P OW R T
BELLVIEW	B EH L V Y UW
BELLVUE	B IH L V UW
BELMAR	B EH L M AA R
BELMOND	B IH L M AA N D
BELPRE	B IH L P AH R
BELTRAMI	B IH L T R AE M IY
BELVIEW	B EH L V Y UW
BELVUE	B IH L V UW
BELWOOD	B EH L W UH D
BELZONI	B IH L Z AA N IY
BEMUS	B IY M AH S
BENDAVIS	B IH N D EY V AH S
BENDENA	B IH N D EH N AH
BENEZETT	B AH N EH Z AH T
BENICIA	B AH N IH SH IY AH
BENINGO	B IY AH N IH N G OW
BENKELMAN	B IH NG K EH L M AH N
BENLD	B EH N L D
BENNETTSVILLE	B IH N EH T S V AH L
BENSENVILLE	B IH N S EH N V AH L
BENTLEYVILLE	B IH N T L EY V AH L
BENTONIA	B IH N T OW N Y AH
BENTREE	B IY AH N T R IY
BENWOOD	B IY AH N W UH D
BENZONIA	B IH N Z OW N Y AH
BEOWAWE	B AH OW AH
BEQUE	B AH K IY
BERCKMAN	B AH R K M AH N
BERGENLINE	B ER G AH N L AY N
BERGENWOOD	B ER G AH N W UH D
BERGHEIM	B AH R IY M
BERGHOLZ	B AH R OW L Z
BERGTON	B ER G T AH N
BERNALILLO	B IH R N AH L IH L OW
BERNARDSVILLE	B IH R N AA R D S V AH L
BERNHARDS	B IH R N HH AA R D Z
BERNVILLE	B IH R N V IH L
BEROUN	B AH R AW N
BERRIMAN	B IH R AY M AH N
BERRYSBURG	B IH R IH Z AH R G
BERRYTON	B EH R IY T AH N
BERRYVILLE	B IH R IH V AH L
BERSEY	B EH R Z IY
BERTHOUD	B IH R TH AW D
BERWIN	B IY ER W IH N
BESSEMUND	B IH S EH M AH N D
BESSIDA	B IH S IH D AH
BETHALTO	B IY IH TH AE L T OW
BETHANNA	B AH TH AE N AH
BETHE	B AH DH IY
BETHELRIDGE	B EH TH AH L R IH JH
BETHTON	B IY IH TH T AH N
BETTLES	B EH T AH L Z
BETTLEWOOD	B IH T L UW UW D
BEULAVILLE	B AH Y UW L AH V AH L
BEVERWYCK	B AH V AH R W AH K
BEVINSVILLE	B AH V IH N S V AH L
BEXAR	B EH K S AH R
BIALYSTOKER	B AY EY L IY S T OW K ER
BICKLETON	B AY K L EH T AH N
BIDDEFORD	B IH D IY F OW R D
BIENVILLE	B AY AH N V IH L
BIGFORK	B IH G F AO R K
BIGGSVILLE	B AY G S V IH L
BIGLERVILLE	B AY G L AH R V AH L
BIJOU	B AY JH UW
BILLINGSPORT	B IH L IH NG S P OW R T
BILLIOU	B AY L AY UW
BILLOP	B AY L AA P
BIM	B IH M
BIMBLE	B AY M B AH L
BIMBLER	B IH M B L AH R
BIONIA	B AY OW N Y AH
BIRCHDALE	B ER CH D EY L
BIRCHLEAF	B ER CH L IY F
BIRCHWOOD	B ER CH W UH D
BIRDEYE	B ER D AY
BIRDSBORO	B AY R D S B AO R OW
BIRDSNEST	B ER D Z N EH S T
BIRKSHIRE	B AY R K AY R
BIRMINGTON	B AY R M IH N G T AH N
BIRNAMWOOD	B AY R N AE M W UW D
BISHOPVILLE	B AY SH AA P V AH L
BISPHAM	B AY S AE M
BISSEL	B AY S EH L
BITELY	B AY T L IY
BK	B IY K
BKLYN	B K L IH N
BL	B IY L
BLACHLEY	B L AE K L IY
BLACKBURNE	B L AE K B AH R N
BLACKDUCK	B L AE K D AH K
BLACKHORSE	B L AE K HH AO R S
BLACKLICK	B L AE K L IH K
BLACKRIDGE	B L AE K R IH JH
BLACKSVILLE	B L AE K S V AH L
BLACKVILLE	B L AE K V AH L
BLACKWATER	B L AE K W AO T ER
BLADENBORO	B L AH D EH N B AH R OW
BLADENSBURG	B L AH D EH N S B AH R G
BLAIRS	B L AE AH R Z
BLAIRSBURG	B L AE AH R S B AH R G
BLAIRSTOWN	B L AE AH R S T OW N
BLAIRSVILLE	B L AE AH R S V AH L
BLAKESBURG	B L AH K EH Z AH R G
BLANCHARDVILLE	B L AE NG K AA R D AH L
BLANCHESTER	B L AE N CH AH S T ER
BLANCKE	B L AE NG K
BLANDINSVILLE	B L AE N D IH N S V AH L
BLANDVILLE	B L AE N D AH L
BLAWNOX	B L AO N AH K S
BLDG	B IY EH L D IY G
BLECKLEY	B L EH K L IY
BLEIBLERVILLE	B L IY B L AH R V AH L
BLENCOE	B L EH NG K OW
BLISSFIELD	B L IH S F IY L D
BLOCKTON	B L AA K T AH N
BLOCTON	B L AA K T AH N
BLONDEL	B L AA N D AH L
BLOOMBURG	B L UW M B AH R G
BLOOMDALE	B L UW M D EY L
BLOOMERY	B L UW M AH R IY
BLOOMINGBURG	B L UW M IH N G AH R G
BLOOMINGROSE	B L UW M IH NG R OW Z
BLOOMINGVI	B L UW M IH N G IY
BLOOMSBURG	B L UW M Z AH R G
BLOOMSBURY	B L UW M Z B EH R IY
BLOOMSDALE	B L UW M Z D EY L
BLOOMVILLE	B L UW M V AH L
BLOSSBURG	B L AA S B AH R G
BLOSSVALE	B L AA S V EY L
BLOUNTS	B L AW N T S
BLOUNTSTOWN	B L AW N T S T OW N
BLOUNTSVILLE	B L AW N T S V AH L
BLOUNTVILLE	B L AW N T V AH L
BLOY	B L OW IY
BLUEJACKET	B L UW JH AE K AH T
BLUEMONT	B L UW AH M AH N T
BLUEWATER	B L UW W AO T ER
BLUEWELL	B L UW W EH L
BLUFFTON	B L AH F T AH N
BLVD.	B IY EH L V IY D IY
BLVDAT	B L V D AE T
BLYTHEDALE	B L IH TH AH D EY L
BLYTHEVILLE	B L IH TH AH V AH L
BLYTHEWOOD	B L IH TH UW UW D
BOALSBURG	B OW L S B AH R G
BODFISH	B AA D F AH SH
BOELSEN	B OW EH L Z AH N
BOELUS	B OW AH L AH S
BOERUM	B AH R AH M
BOGALUSA	B AA G AH L UW S AH
BOGATA	B AA G AH T AH
BOGGSTOWN	B AA G S T OW N
BOHRENS	B AA R AH N Z
BOICEVILLE	B OY S AH V AH L
BOKCHITO	B AA K AH T OW
BOKEE	B OW K IY IY
BOKEELIA	B OW K IY L Y AH
BOKOSHE	B AA K AH SH
BOLAIR	B AA L AH AH R
BOLCKOW	B OW L K OW
BOLIGEE	B AA L AH JH IY IY
BOLINAS	B AA L AH N AH Z
BOLINGBROOK	B AH L IH N G R AH K
BOMONT	B AA M AH N T
BONAIRE	B AA N AH AH R
BONDVILLE	B AA N D AH L
BONETRAILL	B AA N AH T R EY L
BONNA	B AA N AH
BONNERDALE	B AO N ER D EY L
BONNERS	B AO N ER Z
BONNIEVILLE	B AA N IY V AH L
BONNOTS	B AA N AH T S
BOODYS	B UW D AH Z
BOONES	B UW N Z
BOONESVILLE	B UW N EH Z AH L
BOONEVILLE	B UW N AH V AH L
BOORAEM	B AH R IY M
BOOREAM	B UW R IY M
BOOTHBAY	B UW TH B EY
BOOTHWYN	B UW TH W AH N
BOR	B IY ER
BORAGE	B AO R IH JH
BORDENTOWN	B IY ER D EH N T AW N
BORDULAC	B AO R D Y UW L AH K
BORGATA	B AO R G AH T AH
BORINQUEN	B AH R IH NG K W AH N
BORKEL	B AO R K AH L
BORRIE	B IY ER IY
BORTIC	B AO R T AH K
BOSCAWEN	B AA S AH AH N
BOSCOBEL	B AA S AH B AH L
BOSCOMBE	B AA S AH M
BOSCOVS	B AA S AH V Z
BOSQUE	B AA S
BOSSUM	B AA S AH M
BOTTINEAU	B AA T IH N IY UW
BOUCKVILLE	B AW K V AH L
BOULEV	B AW L AH V
BOUNDBROOK	B AW N D B R UH K
BOUNDRY	B AW N D R IY
BOURBONNAIS	B AH R B AA N EY AH S
BOURTON	B AH R T AH N
BOVANIZER	B AA V AH N AY Z AH R
BOWDENS	B AW D EH N Z
BOWDOINHAM	B AW D UW IH N HH AE M
BOWDON	B AW D AA N
BOWERSTON	B AW ER Z T AH N
BOWERSVILLE	B OW AH R S V AH L
BOWESMONT	B OW EH Z M AH N T
BOWFELL	B AW F EH L
BOWMANSVILLE	B OW M AE N S V AH L
BOXBORO	B AA K S B AH R OW
BOXFORD	B AA K S F OW R D
BOXHOLM	B AA K S OW L M
BOYCEVILLE	B OY S AH V AH L
BOYDS	B OY D Z
BOYDTON	B OY D T AH N
BOZOO	B AA Z UW
BOZRAH	B AA Z R AH
BR	B IY R
BRABRANT	B R AE B R AH N T
BRACEVILLE	B R AE S AH V AH L
BRACKENRIDGE	B R AE K AH N R IH JH
BRACKETTVILLE	B R AE K EH T V AH L
BRADDYVILLE	B R AE D AH V AH L
BRADENVILLE	B R AH D EH N V AH L
BRADFORDSVILLE	B R AE D F AO R D S V AH L
BRADFORDWOODS	B R AE D F OW R D W UH D Z
BRADGATE	B R AE D G EY T
BRADHURST	B R AE D HH AH R S T
BRADLEYVILLE	B R AE D L EY V AH L
BRADSON	B R AE D S AH N
BRADYVILLE	B R AE D AH V AH L
BRAEMAR	B R EY M AA R
BRAEN	B R EY AH N
BRAGAW	B R AE G AH
BRAISTED	B R EY IH S T IH D
BRAKELEY	B R AH K IY L IY
BRANCHDALE	B R AE N CH D EY L
BRANCHLAND	B R AE N CH L AE N D
BRANCHPORT	B R AE N CH P OW R T
BRANCHVILLE	B R AE NG K V AH L
BRANDRIFF	B R AE N D R IH F
BRANDSVILLE	B R AE N D S V AH L
BRANTFORD	B R AE N T AH R D
BRANTWOOD	B R AE N T W UW D
BRASSTOWN	B R AE S T AW N
BRATTLEBORO	B R AE T L EH B AH R OW
BRAYMER	B R EY M AH R
BRAZORIA	B R AH Z AO R IY AH
BRECKSVILLE	B R EH K S V AH L
BREESPORT	B R IY S AH R T
BREEZEWOOD	B R IY Z W UH D
BREHAUT	B R EH HH AH T
BREIEN	B R IY AH N
BREINIGSVILLE	B R IY N IH G S V AH L
BREMERTON	B R AH M AH R T AH N
BREMO	B R EH M OW
BREMOND	B R EH M AH N D
BRENHAM	B R EH N HH AH M
BRENTFORD	B R EH N T AH R D
BRENWAL	B R EH N W AH L
BREVENT	B R EH V AH N T
BREVOORT	B R EH V AH R T
BREWERTON	B R UW ER T AH N
BRG	B IY AA R G
BRIARHILL	B R AY ER HH IH L
BRIARKIM	B R AY AE R K AH M
BRIARWOOD	B R AY ER W UH D
BRICELYN	B R IH S AH L AH N
BRICKEYS	B R IH K EY Z
BRICKTOWN	B R IH K T AW N
BRIDEWELL	B R AY D W EH L
BRIDG	B R IH JH
BRIDGEBORO	B R IH JH EH B AH R OW
BRIDGEHAMPTON	B R IH JH AH HH AE M P T AH N
BRIDGELAND	B R IH JH L AE N D
BRIDGEVIEW	B R IH JH V Y UW
BRIDGEVILLE	B R IH JH AH V AH L
BRIDGTON	B R IH JH T AH N
BRIDPORT	B R IH D P AH R T
BRIELLE	B R IY L
BRIENNA	B R IY N AH
BRIERFIELD	B R IY R F IY L D
BRIGANTINE	B R IH G AH N T IY N
BRIGGSDALE	B R IH G S D EY L
BRIGGSVILLE	B R IH G S V AH L
BRIGHTWATER	B R AY T W AO T ER
BRIGHTWATERS	B R AY T W AO T ER Z
BRIGHTWOOD	B R AY T W UH D
BRILLION	B R IH L IY AH N
BRIMFIELD	B R IH M F IY L D
BRIMSON	B R IH M S AH N
BRINDLETOWN	B R IH N D AH L T AW N
BRINKHAVEN	B R IH NG K HH EY V AH N
BRINKLOW	B R IH NG K L OW
BRINKTOWN	B R IH NG K T AW N
BRINNON	B R IH N AH N
BRINSMADE	B R IH N S M EY D
BRINY	B R AY N IY
BRISBEN	B R IH Z AH N
BRISTOLVILLE	B R IH S T OW L V AH L
BROADACRES	B R AO D EY K ER Z
BROADALBIN	B R AO D AH L B IH N
BROADFORD	B R AO D F OW R D
BROADLANDS	B R AO D L AE N D Z
BROADLAWN	B R AO D L AO N
BROADMAN	B R AO D M AE N
BROADWATER	B R AO D W AO T ER
BROCHER	B R AA CH AH R
BROCKET	B R AA K AH T
BROCKPORT	B R AA K AH R T
BROCTON	B R AA K T AH N
BRODBECKS	B R AA D AH K S
BRODHEADSVILLE	B R AA D HH IY D S V AH L
BROEMEL	B R OW AH M AH L
BROGUE	B R AA G
BROHARD	B R AA HH AH R D
BRONWOOD	B R AA N W UW D
BRONXDALE	B R AO NG K S D EY L
BRONXVILLE	B R AO NG K S V AH L
BRONXWOOD	B R AO NG K S W UW D
BROO	B R UW
BROOKDALE	B R UH K D EY L
BROOKELAND	B R UH K AH L AH N D
BROOKESMITH	B R AH K EH Z M AH TH
BROOKEVILLE	B R UH K AH V AH L
BROOKLAND	B R UH K L AE N D
BROOKLAWN	B R UH K L AO N
BROOKLET	B R UH K L AH T
BROOKLEY	B R UH K L IY
BROOKLIN	B R UH K L AH N
BROOKNEAL	B R UH K N IY AH L
BROOKPARK	B R UH K P AA R K
BROOKSPOND	B R UH K S P AA N D
BROOKSTON	B R UH K S T AH N
BROOKTON	B R UH K T AH N
BROOKTONDALE	B R UH K T AH N D EY L
BROOKVILLE	B R UH K V AH L
BROOKWAY	B R UH K W EY
BROOKWOOD	B R UH K W UH D
BROOMES	B R UW M Z
BROOTEN	B R UW T AH N
BROSELEY	B R AH S IY L IY
BROWERTOWN	B R AW ER T AW N
BROWERVILLE	B R OW AH R V AH L
BROWNDALE	B R AW N D EY L
BROWNES	B R OW N Z
BROWNSBORO	B R OW N S B AH R OW
BROWNSBURG	B R OW N S B AH R G
BROWNSDALE	B R AW N Z D EY L
BROWNSTOWN	B R AW N Z T AW N
BROWNTON	B R AW N T AH N
BROWNTOWN	B R AW N T AW N
BROWNVILLE	B R OW N V AH L
BROWVALE	B R AW V EY L
BRUCETON	B R UW S AH T AH N
BRUCEVILLE	B R UW S AH V AH L
BRUNNERVILLE	B R AH N AH R V AH L
BRUNOZZI	B R UW N AA Z IY
BRUSHTON	B R AH SH T AH N
BRUSLY	B R AH Z L IY
BRYANTOWN	B R AY AH N T OW N
BRYANTS	B R AY AH N T S
BRYCEVILLE	B R IH S AH V AH L
BRYTE	B R AY T
BTW	B IY T IY W
BUCKATUNNA	B AH K AH T AH N AH
BUCKFIELD	B AH K F IY L D
BUCKHEAD	B AH K HH EH D
BUCKHOLTS	B AH K OW L T S
BUCKSPORT	B AH K S P OW R T
BUCKVILLE	B AH K V AH L
BUCYRUS	B Y UW S AH R AH S
BUDA	B Y UW D AH
BUELLTON	B Y UW EH L T AH N
BUENAVENTURA	B Y UW AH N AH V EH N T Y AH R AH
BUEYEROS	B Y UW AH AY AH R AH Z
BUFFALOVILLE	B AH F AE L AH V AH L
BUHRE	B AH R
BULWER	B AH L W AH R
BUNA	B Y UW N AH
BUNCETON	B AH N S AH T AH N
BUNCOMBE	B AH N K OW M
BUNNECKE	B AH N AH K
BUNNLEVEL	B AH N L AH V AH L
BUNNS	B AH N Z
BURFORDVILLE	B AH R F AO R D AH L
BURGAW	B AH R G AH
BURGHILL	B AH R AH L
BURIEN	B EH R IY AH N
BURKBURNETT	B AH R K B AH R N AH T
BURKESVILLE	B AH R K EH Z AH L
BURKEVILLE	B AH R K AH V AH L
BURKITTSVILLE	B AH R K IH T S V AH L
BURKVILLE	B AH R K V AH L
BURNA	B AH R N AH
BURNETTSVILLE	B AH R N EH T S V AH L
BURNEYVILLE	B AH R N EY V AH L
BURNIE	B ER N IY
BURNLEYS	B AH R N L EY Z
BURNSTAD	B AH R N S T AH D
BURNSVILLE	B AH R N S V AH L
BURNWELL	B ER N W EH L
BURRS	B ER Z
BURRTON	B ER T AH N
BURTONSVILLE	B AH R T AA N S V AH L
BURTRUM	B AH R T R AH M
BURWOOD	B AH R W UW D
BUSHKILL	B UH SH K IH L
BUSHTON	B UH SH T AH N
BUSHWICK	B UH SH W IH K
BUSHWOOD	B UH SH W UH D
BUSTINS	B AH S T IH N Z
BUTLERVILLE	B AH T L AH R V AH L
BUTTELL	B AH T AH L
BUTTERNUT	B AH T ER N AH T
BUTTONWILLOW	B AH T AH N W IH L OW
BUTTONWOOD	B AH T AH N W UH D
BUTZTOWN	B AH T S T OW N
BUYCK	B Y UW AH K
BVD	B IY V IY D
BYESVILLE	B AY EH Z AH L
BYHALIA	B AH HH EY L Y AH
BYLAS	B IH L AH Z
BYRDSTOWN	B AH R D S T OW N
BYRNEDALE	B AH R N AH D EY L
BYROMVILLE	B AH R AA M V AH L
CABALLO	K AH B AE L OW
CABAZON	K AE B AH Z AH N
CABERY	K AE B AH R IY
CABLECAR	K EY B AH L K AA R
CABOOL	K AH B UW L
CACAPON	K AE K AH P AH N
CADDO	K AE D OW
CADDOA	K AE D OW AH
CADES	K EY D Z
CADOSIA	K AH D OW ZH IY AH
CADOTT	K AE D AH T
CADYVILLE	K AE D AH V AH L
CAHABA	K AE HH AH B AH
CAHOKIA	K AH HH OW K IY AH
CAHONE	K AH HH OW N
CAINS	K EY N Z
CAINSVILLE	K EY N S V AH L
CAIRNBROOK	K AE ER N B R UH K
CAJON	K AE JH AH N
CALABASH	K AE L AH B AH SH
CALAMUS	K AE L AH M AH S
CALCASIEU	K AE L K EY S Y UW
CALERA	K AE L AH R AH
CALEXICO	K AH L EH K S AH K OW
CALHAN	K AE L AH N
CALIENTE	K EY L IY N T
CALIFON	K AE L AH F AH N
CALIMESA	K AH L IH M AH S AH
CALIO	K EY L IY OW
CALIPATRIA	K AE L AH P AE T R IY AH
CALISTOGA	K AH L IH S T AH G AH
CALLANDS	K AE L AH N D Z
CALLAO	K AE L EY OW
CALLENSBURG	K AE L EH N S B AH R G
CALLICOON	K AE L AH S UW N
CALLIHAM	K AE L AH HH AH M
CALLSBURG	K AE L S B AH R G
CALORIS	K AE L AH R AH S
CALPINE	K AE L P AY N
CALVANICO	K AE L V AE N AH K OW
CALVERTON	K AE V ER T AH N
CALWA	K AE L W AH
CALYER	K AE L AY AH R
CAMANCHE	K AE M AH NG K
CAMAS	K AE M AH Z
CAMBERLENG	K AE M B AH R L AH NG
CAMBRELENG	K AE M B R AH L AH NG
CAMDENTON	K AE M D EH N T AH N
CAMEY	K EY M IY
CAMILLUS	K AH M IH L AH S
CAMMAL	K AE M AH L
CAMPBELLSBURG	K AE M P B EH L S B AH R G
CAMPBELLSPORT	K AE M P B EH L S P OW R T
CAMPBELLSVILLE	K AE M P B EH L S V AH L
CAMPBELLTON	K AE M P B EH L T AH N
CAMPGAW	K AE M P G AH
CAMPOBELLO	K AE M P AH B EH L OW
CAMPTI	K AE M P T IY
CAMPTONVILLE	K AE M P T AA N V AH L
CANADENSIS	K EY N EY D AH N Z IY Z
CANARSIE	K EY N ER Z IY
CANASERAGA	K AE N AH S EH R AH G AH
CANASTOTA	K AH N AE S T AH T AH
CANDA	K AE N D AH
CANDIDUS	K AE N D AH D AH S
CANDON	K AE N D AA N
CANEADEA	K EY N IY D IY AH
CANEHILL	K EY N HH IH L
CANEY	K EY N IY
CANEYVILLE	K EY N EY V AH L
CANGER	K AE NG AH R
CANISTEO	K AH N IH S T IY OW
CANISTOTA	K AH N IH S T AH T AH
CANKTON	K AE NG K T AH N
CANMER	K AE N M AH R
CANNELBURG	K AE N EH L B AH R G
CANONCITO	K AH N AA N S AH T OW
CANTIL	K AE N T AH L
CANTILLON	K AE N T IH L AO N
CANTONMENT	K AE N T AH N M AH N T
CANTRIL	K AE N T R AH L
CANTUA	K AE N T Y UW AH
CANUTE	K AE N Y UW T
CANUTILLO	K AE N Y AH T IH L OW
CANYONDAM	K AE N Y AH N D AE M
CANYONVILLE	K AE N AY AA N V AH L
CAPADONNO	K AE P AH D AA N OW
CAPAY	K AE P EY IY
CAPELLAN	K AH P EH L AH N
CAPITOLA	K AH P IH T AH L AH
CAPODANNA	K AE P AH D AE N AH
CAPODANNO	K AE P AH D AE N OW
CAPROCK	K AE P R AA K
CAPTIVA	K AE P T AH V AH
CAPUCHIN	K AE P AH CH AH N
CAPULIN	K AE P Y UW L AH N
CAPUTA	K AE P Y UW T AH
CARATUNK	K AE R AH T AH NG K
CARBONADO	K AA R B AH N AH D UW
CARBURY	K AA R B EH R IY
CARCASSONNE	K AA R K AE S AH N
CARDINGTON	K AA R D IH NG T AH N
CARDVILLE	K AA R D AH L
CARENCRO	K AH R EH NG K R OW
CARET	K AE R AH T
CAREYWOOD	K EH R IY W UH D
CARMELLA	K AA R M EH L AH
CARMI	K AA R M IY
CARMICHAELS	K AA R M AH CH IY L Z
CARNELIAN	K AA R N IY L IY AH N
CARNESVILLE	K AA R N EH Z AH L
CARNEYS	K AA R N IY Z
CAROGA	K AE R AH G AH
CAROLL	K AE R AH L
CARONA	K AE R AH N AH
CARONDELET	K AA R AO N D IY L EH T
CARPENTERSVILLE	K AA R P AH N T AH R S V AH L
CARPINTERIA	K AA R P AH N T IY R IY AH
CARRABELLE	K AE R AH B AH L
CARRBORO	K AE R B AH R OW
CARREAU	K AE R IY UW
CARRIZO	K AE R AH Z OW
CARRIZOZO	K AE R IH Z AH Z OW
CARROLLTOWN	K AA R OW L T AW N
CARROLLTOWNE	K AE R AH L T OW N
CARROLLWOOD	K AA R OW L W UH D
CARRSVILLE	K AE R S V AH L
CARSONVILLE	K AA R S AA N V AH L
CARTERVILLE	K AA R T AH R V AH L
CARTHAGENA	K AA R TH AE JH AH N AH
CARTIGAN	K AA R T AH G AH N
CARUTHERSVILLE	K AE R AH TH AH R S V AH L
CARVERSVILLE	K AA R V AH R S V AH L
CARYVILLE	K AE R AH V AH L
CASAR	K EY S ER
CASCADIA	K AE S EY D IY AH
CASCILLA	K AE S IH L AH
CASEVILLE	K AE S AH V AH L
CASEYVILLE	K EY S EY V AH L
CASHS	K AE SH S
CASHTON	K AE SH T AH N
CASKILL	K AE S K IH L
CASNOVIA	K AE Z N OW V IY AH
CASPIANA	K AE S IY AH N AH
CASSADAGA	K AE S AE D AH G AH
CASSCOE	K AE S OW
CASSELTON	K AE S EH L T AH N
CASSODAY	K AE S AA D EY IY
CASSOPOLIS	K AE S AA P AH L AH S
CASSTOWN	K AE S T OW N
CASSVILLE	K AE S V AH L
CASTABY	K AE S T AH B AY
CASTAIC	K AE S T EY AH K
CASTALIA	K AE S T EY L Y AH
CASTALIAN	K AE S T EY L IY AH N
CASTANA	K AE S T AH N AH
CASTILE	K AE S T AH L
CASTLEFORD	K AE S AH L F OW R D
CASTLETON	K AE S AH L T AH N
CASTLEWOOD	K AE S AH L W UH D
CASTORLAND	K AE S T ER L AE N D
CASTROVILLE	K AE S T R AH V AH L
CATALPA	K AH T AE L P AH
CATASAUQUA	K AE T AH S AO K W AH
CATAULA	K AE T AH L AH
CATAWISSA	K AE T AH IH S AH
CATEECHEE	K EY T AH CH IY IY
CATERET	K AE T AH R AH T
CATHARPIN	K AE T HH AA R P IH N
CATHEYS	K AE T HH EY Z
CATHLAMET	K AE TH L AH M AH T
CATLETTSBURG	K AE T L EH T S B AH R G
CATONSVILLE	K AH T AA N S V AH L
CATOOSA	K AH T UW S AH
CATOR	K EY T ER
CATTANO	K AE T AH N OW
CATTARAUGUS	K AE T AE R AH G AH S
CAUDINA	K AO D AH N AH
CAULDWELL	K AO L D W AH L
CAULLEY	K AO L IY
CAUTHORNVILLE	K AH TH AO R N V AH L
CAVOUR	K AE V AH R
CAWKER	K AO K AH R
CAYSVILLE	K EY Z AH L
CAYUCOS	K EY UW K AH Z
CAYUGA	K EY UW G AH
CAYUTA	K EY UW T AH
CAZA	K AE Z AH
CAZADERO	K AH Z AE D AH R OW
CAZENOVIA	K AE Z AH N OW V IY AH
CBC	S IY B IY S IY
CCC	S IY S IY K
CE	S IY
CEBRA	S EH B R AH
CECILTON	S AH S IH L T AH N
CEDARBLUFF	S IY D ER B L AH F
CEDARBURG	S AH D AA R B AH R G
CEDARBUTTE	S IY D ER B Y UW T
CEDARCLIFF	S IY D ER K L IH F
CEDARCREEK	S IY D ER K R IY K
CEDARCREST	S IY D ER K R EH S T
CEDARCROFT	S IY D ER K R AO F T
CEDAREDGE	S IY D ER EH JH
CEDARHURST	S EH D AH R AH R S T
CEDARTOWN	S IY D ER T AW N
CEDARVALE	S IY D ER V EY L
CEDARVIEW	S IY D ER V Y UW
CEDARVILLE	S AH D AA R V AH L
CEDARWOOD	S IY D ER W UH D
CEDRO	S EH D R OW
CEM	S EH M
CEMETARY	S EH M AH T EH R IY
CENTE	S EH N T
CENTERBROOK	S EH N T ER B R UH K
CENTERBURG	S EH N T AH R B AH R G
CENTEREACH	S EH N T AH R IY CH
CENTERFIELD	S EH N T ER F IY L D
CENTERPOINT	S EH N T ER P OY N T
CENTERPORT	S EH N T ER P OW R T
CENTERTON	S EH N T ER T AH N
CENTERTOWN	S EH N T ER T AW N
CENTERVIEW	S EH N T ER V Y UW
CENTO	S EH N T OW
CENTR	S EH N T R
CENTRA	S EH N T R AH
CENTRAHOMA	S EH N T R AE HH AH M AH
CENTREDALE	S EH N T ER D EY L
CENTREVILLE	S EH N T R AH V AH L
CENTRL	S EH N T R L
CENTURIA	S EH N T Y UH R IY AH
CERESCO	S AH R EH S OW
CERRILLOS	S EH R IH L AH Z
CERULEAN	S AH R UW L IY AH N
CHADBOURN	CH AE D OW R N
CHADDS	CH AE D Z
CHADWICKS	CH AE D W AH K S
CHALFONT	CH AE L F AH N T
CHALKYITSIK	CH AE L K AY IH T S AH K
CHAMA	CH AE M AH
CHAMBERSBURG	CH AE M B AH R S B AH R G
CHAMISAL	CH EY M AH S AH L
CHAMOIS	SH AE M IY
CHANDLERSVILLE	CH AE N D L AH R S V AH L
CHANHASSEN	CH AE N HH AH S AH N
CHANNAHON	CH AE N AH HH AH N
CHANNELVIEW	CH AE N AH L V Y UW
CHANUTE	CH AE N Y UW T
CHAPMANSBORO	CH AE P M AE N S B AH R OW
CHAPMANVILLE	CH AE P M AE N V AH L
CHAPPAQUA	CH AE P AE K W AH
CHAPPELLS	CH AE P AH L Z
CHARDON	CH AA R D AA N
CHARITON	CH AA R IY T AH N
CHARLECOTE	CH AA R L AH K OW T
CHARLEROI	CH AA R L AH R OY
CHARMCO	CH AA R M K OW
CHASEBURG	CH AE S AH B AH R G
CHASELEY	CH AH S IY L IY
CHASSELL	CH AE S AH L
CHATEAUGAY	SH AE T OW G EY
CHATOM	CH AE T AH M
CHATTAROY	CH AE T AE R OW IY
CHAUMONT	CH AO M AH N T
CHAVIES	CH AH V AY Z
CHAZY	CH EY Z IY
CHEBANSE	CH EH B AH N S
CHEBEAGUE	CH IY B IY G
CHEBOYGAN	CH AH B OY G AH N
CHECOTAH	CH EH K AH T AH
CHEESEQUAKE	CH IY Z K W EY K
CHEEVERS	CH IY V AH R Z
CHEFORNAK	CH AH F AO R N AH K
CHEHALIS	CH EH HH AH L AH S
CHELTEN	CH EH L T AH N
CHELTENHAM	CH EH L T EH N HH AH M
CHELTON	CH EH L T AH N
CHEMUNG	K EH M AH NG
CHENANGO	CH AH N AE N G OW
CHENEGA	CH EH N AH G AH
CHENEYVILLE	CH IY N EY V AH L
CHENOA	CH EH N OW AH
CHEPACHET	CH EH P AH CH AH T
CHERAW	CH EH R AH
CHERBA	CH AH R B AH
CHERRYFIELD	CH EH R IY F IY L D
CHERRYLOG	CH EH R IY L AA G
CHERRYVALE	CH EH R IY V EY L
CHERRYVILLE	CH EH R AH V AH L
CHESANING	CH AH S EY N AH NG
CHESBROUGH	CH EH Z R UW
CHESNEE	CH EH Z N IY IY
CHESTERFIEL	CH EH S T AH R F IY L
CHESTERHILL	CH EH S T ER HH IH L
CHESTERLAND	CH EH S T ER L AE N D
CHESTERTOWN	CH EH S T ER T AW N
CHESTNUTRIDGE	CH EH S N AH T R IH JH
CHESWICK	CH EH S W AH K
CHETEK	CH EH T AH K
CHETOPA	CH EH T AH P AH
CHEVAK	CH EH V AH K
CHEWALLA	CH UW AE L AH
CHEWELAH	CH UW AH L AH
CHICKAMAUGA	CH IH K AE M AH G AH
CHICKASHA	CH IH K AH SH AH
CHICOPEE	CH IY K OW P IY
CHICORA	CH IH K AH R AH
CHICOT	CH IH K AH T
CHIEFLAND	CH IY F L AE N D
CHIGNIK	CH IH G N AH K
CHILCOOT	CH IH L K UW T
CHILDWOLD	CH AY L D W OW L D
CHILHOWEE	CH IH L HH OW IY IY
CHILHOWIE	CH IH L HH OW AY
CHILOQUIN	CH AH L AA K W AH N
CHIMACUM	CH IH M AH K AH M
CHINCOTEAGUE	CH IH NG K AH T IY G
CHINLE	CH AY N AH L
CHINQUAPIN	CH IH NG K W AH P AH N
CHIPPERFIELD	CH IH P ER F IY L D
CHIRENO	CH IH R AH N OW
CHIRIACO	CH AH R IY AH K OW
CHISAGO	K AY Z AH G OW
CHITTENANGO	CH IH T AH N AE N G OW
CHITTO	CH IH T OW
CHIVINGTON	CH AY V IH NG T AH N
CHOCORUA	CH AA K AH R UW W AH
CHOCOWINITY	CH AA K OW IH N AH T IY
CHOCTAW	CH AA K T AH
CHOKIO	CH OW K IY OW
CHOLAME	CH AH L EY M
CHOO-CHOO	CH UW CH UW
CHOOCHOO	CH UW CH UW
CHOTEAU	CH OW T IY UW
CHOUDRANT	CH AW D R AH N T
CHOUTEAU	CH AW T IY UW
CHOWCHILLA	CH OW CH IH L AH
CHRISNEY	K R IH Z N IY
CHRISTIANI	K R IH S T IY AH N IY
CHRISTIANSBURG	K R IH S T IY AE N S B AH R G
CHRISTOVAL	K R IH S T AH V AH L
CHRYSTIE	K R IH S T AY
CHUALAR	CH UW W AH L AH R
CHUATHBALUK	CH UW W AE TH B AH L AH K
CHUCKEY	CH AH K IY
CHUGIAK	CH UW JH IY AH K
CHUGWATER	CH AH G W AO T ER
CHULUOTA	CH UW L UW W AH T AH
CHUNCHULA	CH AH NG K Y UW L AH
CHURCHS	CH ER CH S
CHURCHTON	CH ER CH T AH N
CHURCHTOWN	CH ER CH T AW N
CHURCHVILLE	CH AH R CH V AH L
CHURDAN	CH AH R D AH N
CHURUBUSCO	CH UH R AH B AH S OW
CI	S IY
CIARCIA	S AY AE R SH IY AH
CIBOLA	S IH B AH L AH
CIBOLO	S IH B AH L OW
CIMIC	S IH M AH K
CINCINNATUS	S IH N S AH N EY T AH S
CINDA	S IH N D AH
CINEBAR	S IH N AH B AH R
CIRCLEVILLE	S AH R K L AH V AH L
CISNE	S IH Z N
CIT	S IH T
CITIGROUP	S IH T AH G R UW P
CITRA	S IH T R AH
CITRONELLE	S IH T R AH N AH L
CLAI	K L EY
CLAIRFIELD	K L AE AH R F IY L D
CLAIRIDGE	K L AE AH R AH JH
CLAIRSVILL	K L AE AH R S V AH L
CLAIRSVILLE	K L AE AH R S V AH L
CLALLAM	K L AE L AH M
CLARADON	K L AE R AH D AH N
CLAREMORE	K L AE R AH M AH R
CLARES	K L AE R Z
CLARINGTON	K L AH R IH N G T AH N
CLARKDALE	K L AA R K D EY L
CLARKESVILLE	K L AA R K EH Z AH L
CLARKFIELD	K L AA R K IY L D
CLARKIA	K L AA R K IY AH
CLARKLAKE	K L AA R K L EY K
CLARKRANGE	K L AA R K R AH N JH
CLARKRIDGE	K L AA R K R AH JH
CLARKSBORO	K L AA R K S B AH R OW
CLARKSDALE	K L AA R K S D EY L
CLARKTON	K L AA R K T AH N
CLARYVILLE	K L AE R AH V AH L
CLATONIA	K L AH T OW N Y AH
CLAUDVILLE	K L AO D AH L
CLAVE	K L EY V
CLAVER	K L EY V AH R
CLAVERACK	K L AE V AH R AH K
CLAYBOARD	K L EY B OW R D
CLAYHOLE	K L EY HH OW L
CLAYSBURG	K L EY Z AH R G
CLAYSVILLE	K L EY Z AH L
CLAYVILLE	K L EY V AH L
CLE	K AH L
CLEARBROOK	K L IH ER B R UH K
CLEARFIELD	K L IH ER F IY L D
CLEARLAKE	K L IH ER L EY K
CLEARMONT	K L AH R M AH N T
CLEARVIEW	K L IH ER V Y UW
CLEARVILLE	K L AH R V AH L
CLEBURNE	K L EH B AH R N
CLEEF	K L IY F
CLELLAN	K L EH L AH N
CLELLANVILLE	K L EH L AE N V AH L
CLEMENTON	K L EH M AH N T AH N
CLENDENNY	K L EH N D EH N IY
CLEONA	K L IY AH N AH
CLEOPATRAS	K L IY AH P AE T R AH Z
CLEREMONT	K L EH R AH M AH N T
CLETUS	K L IY T AH S
CLEVES	K L IY V Z
CLIFFSIDE	K L IH F S AY D
CLIFFTOP	K L IH F T AA P
CLIFFWOOD	K L IH F W UH D
CLIFTY	K L IH F T IY
CLINCHCO	K L IH NG K OW
CLINCHPORT	K L IH N CH P OW R T
CLINTONDALE	K L IH N T AH N D EY L
CLINTONVILLE	K L IH N T AA N V AH L
CLINTWOOD	K L IH N T W UW D
CLITHERALL	K L IH TH AH R AH L
CLODINE	K L AH D AY N
CLONTARF	K L AA N T AH R F
CLOQUET	K L AA K AH T
CLOSPLINT	K L AA S L AH N T
CLOSTER	K L AA S T AH R
CLOUDCROFT	K L AW D K R AO F T
CLOUDLAND	K L AW D L AE N D
CLOVE	K L OW V
CLOVERDALE	K L OW V ER D EY L
CLOVERPORT	K L OW V ER P OW R T
CLURE	K L UH R
CLURG	K L AH R G
CLUTIER	K L UW T AY AH R
CLYATTVILLE	K L AY AE T V AH L
CLYO	K L AY OW
CMNS	S IY EH M EH N S
CNTRL	S IY EH N T IY AA R L
CNTY	K N T AY
COACHELLA	K OW AH CH EH L AH
COAHOMA	K OW AE HH AH M AH
COALBURG	K OW AE L B AH R G
COALDALE	K OW L D EY L
COALGATE	K OW L G EY T
COALGOOD	K OW L G UH D
COALINGA	K OW AH L IH N G AH
COALMONT	K OW AE L M AH N T
COALPORT	K OW L P OW R T
COALTON	K OW L T AH N
COALVILLE	K OW AE L V AH L
COARSEGOLD	K OW R S G OW L D
COASTWISE	K OW S T W AY Z
COATOPA	K OW AE T AH P AH
COATSBURG	K OW AE T S B AH R G
COATSVILLE	K OW AE T S V AH L
COBBTOWN	K AA B T OW N
COBDEN	K AA B D AH N
COBECK	K OW B EH K
COBHAM	K OW B HH AE M
COBHILL	K OW B HH IH L
COBLESKILL	K OW B AH L S K IH L
COBURG	K OW B AH R G
COCHECTON	K OW CH EH K T AH N
COCHISE	K OW CH AY Z
COCHITI	K OW CH IH T IY
COCHRANVILLE	K OW K R AE N V AH L
COCKEYSVILLE	K AA K EY Z AH L
COCOLALLA	K OW K AH L AE L AH
COCOLAMUS	K OW K AH L EY M AH S
CODELL	K OW D EH L
CODEN	K OW D EH N
CODWISE	K AA D W AY Z
COENTIES	K OW EH N T AY Z
COEYMAN	K OW EY M AH N
COEYMANS	K OW EY M AH N Z
COFFEEVILLE	K AA F IY V AH L
COFFEYVILLE	K AA F EY V AH L
COGGON	K AA G AA N
COHAGEN	K AA AH JH AH N
COHANCY	K AA AE N S IY
COHAWKIN	K OW HH AO K IH N
COHOCTON	K OW HH AA K T AH N
COHOES	K OW HH OW Z
COHUTTA	K OW HH AH T AH
COILA	K OW IH L AH
COINJOCK	K OW IH N JH AA K
COKATO	K OW K AE T OW
COKEBURG	K OW K EH B AH R G
COKEVILLE	K OW K EH V AH L
COLCHESTER	K OW L CH EH S T AH R
COLDFOOT	K OW L D F UH T
COLDSPRING	K OW L D S P R IH NG
COLEHARBOR	K OW L HH AA R B ER
COLERAIN	K OW L R EY N
COLESBURG	K OW L EH Z AH R G
COLESVILLE	K OW L EH Z AH L
COLFAX	K AA L F AE K S
COLITA	K OW L IH T AH
COLLBRAN	K AA L B R AH N
COLLETTSVILLE	K AA L EH T S V AH L
COLLEYVILLE	K AA L EY V AH L
COLLFIELD	K AA L F IY L D
COLLIERVILLE	K AA L IY R V AH L
COLLINGDALE	K AA L IH N G D EY L
COLLINGSWOOD	K AA L IH N G S W UW D
COLLINSTON	K AA L IH N S T AH N
COLLINSVILLE	K AA L IH N S V AH L
COLLINWOOD	K AA L IH N W UW D
COLMA	K AA L M AA
COLMAR	K OW L M AH R
COLOME	K OW L OW M
COLORA	K OW L AO R AH
COLRAIN	K AA L R EY N
COLTONS	K OW L T AO N Z
COLUMBIANA	K OW L AH M B IY AH N AH
COLUMBIAVILLE	K OW L AH M B IY AH V AH L
COLUSA	K OW L UW S AH
COLWICH	K OW L W IH CH
COLWICK	K OW L W IH K
COMM	K AA M
COMM.	K AA M
COMMISKEY	K AH M IH S K IY
COMMO	K AA M OW
COMMUNIPAW	K AA M Y UW N AH P AH
COMPTCHE	K AA M CH IY
CONCAN	K AH N K AE N
CONCHAS	K AA N CH AE Z
CONCHO	K AA N CH OW
CONCORDIA	K AA N K AH R D AY AH
CONDA	K AA N D AA
CONEHATTA	K AH N AH HH AE T AH
CONESUS	K OW N Z AH S
CONESVILLE	K AH N EH Z AH L
CONEWANGO	K OW N W AA N G OW
CONGERS	K AA N JH EH R Z
CONGERVILLE	K AA N JH AH R V AH L
CONICVILLE	K AH N IH K V AH L
CONKLINTOWN	K AA N K L IH N T OW N
CONNEAUT	K AA N IY AH T
CONNEAUTVILLE	K AA N IY AH T V AH L
CONNELLS	K AA N EH L Z
CONNELLSBURG	K AA N EH L S B AH R G
CONNELLSVI	K AA N EH L S V IY
CONNELLSVILLE	K AA N EH L S V AH L
CONNELLYS	K AA N EH L AH Z
CONNELSVILLE	K AA N EH L S V AH L
CONNERSVILLE	K AA N AH R S V AH L
CONOWINGO	K AH N OW IH N G OW
CONSELYEA	K AA N S AH L AY IY AH
CONSEQU	K AA N S EH K W
CONSHOHOCKE	K AA N SH AA HH AH K
CONSTABLEVILLE	K AA N S T AE B L AH V AH L
CONSTANTIA	K AA N S T AE N CH IY AH
CONT	K AA N T
CONYINGHAM	K OW N IY IH NG HH AE M
COOKSBURG	K OW AA K S B AH R G
COOKSTOWN	K UH K S T AW N
COOKSVILLE	K OW AA K S V AH L
COOKVILLE	K OW AA K V AH L
COOLIN	K UW L IH N
COOLSPRING	K UW L S P R IH NG
COOLVILLE	K OW OW L V AH L
COONLEY	K OW AA N L IY
COOPERSBURG	K OW AH P AH R S B AH R G
COOPERSVILLE	K OW AH P AH R S V AH L
COOSAWATCHIE	K OW AA S AH W AA CH IY
COPAKE	K OW P EY K
COPALIS	K OW P EY L IY Z
COPAN	K OW P AE N
COPEMISH	K OW P IY M AH SH
COPEWOOD	K OW P W UH D
COPIN	K OW P IH N
COPLAY	K OW P L EY
COPPELL	K AH P EH L
COPPERFLAGG	K AH P AH R F L AH G
COPPERLEAF	K AA P ER L IY F
COPPEROPOLIS	K AH P AH R AA P AH L AH S
COQUILLE	K OW K W IH L
CORALVILLE	K OW R AE L V AH L
CORAPEAKE	K OW R AH P IY K
CORDELE	K AA R D IY L
CORDELIA	K AO R D IY L IY AH
CORDERY	K AO R D AH R IY
CORDESVILLE	K AA R D EH Z AH L
CORDSVILLE	K AA R D S V IH L
CORFU	K AA R F UW
CORLEAR	K AA R L IY AH R
CORNAGA	K AA R N AE G AH
CORNERSVILLE	K AA R N AH R S V AH L
CORNISHVILLE	K AA R N IH SH V AH L
CORNVILLE	K AA R N V IH L
CORNWALLVILLE	K AA R N W AA L V AH L
CORRECTIONVILLE	K AA R EH K T IY AA N V AH L
CORREJA	K AA R EH JH AH
CORRIELLE	K AA R IY L
CORRYTON	K AA R IH T AH N
CORSICANA	K AA R S IH K AH N AH
CORTLANDT	K AA R T L AE N D T
CORUNNA	K OW R AH N AH
CORWITH	K OW R W IH TH
CORYDON	K OW R IY D AA N
CORYN	K OW R IH N
COSDEN	K AA Z D AH N
COSHOCTON	K OW SH AA K T AH N
COSMEN	K AA Z M AH N
COSMOPOLIS	K AA S M AA P AH L AH S
COSSAYUNA	K AA S EY UW N AH
COSTILL	K OW S T IH L
COTATI	K OW T AE T IY
COTEAU	K OW T IY UW
COTESFIELD	K OW T EH S IY L D
COTLUSS	K AA T L AH S
COTTAGEVILLE	K AA T AE JH AH V AH L
COTTEKILL	K AA T EH K AH L
COTTONDALE	K AA T AH N D EY L
COTTONPORT	K AA T AH N P OW R T
COTTONTAIL	K AA T AH N T EY L
COTTONTOWN	K AA T AH N T AW N
COTTRELLVILLE	K AA T R EH L V AH L
COTUIT	K OW T UW T
COTULLA	K OW T AH L AH
COULDN	K OW AH L D N
COULTERVILLE	K OW AH L T AH R V AH L
COUPEVILLE	K OW Y UW P AH V AH L
COURTLANDT	K OW AH R T L AH N D T
COVELO	K OW V EH L OW
COVERLY	K OW V EH R L IY
COVESVILLE	K OW V EH Z AH L
COWANSVILLE	K OW W AA N S V AH L
COWETA	K OW W EH T AH
COWICHE	K OW W IH CH
COWLESVILLE	K OW W L EH Z AH L
COWPENS	K AW P EH N Z
COXS	K AA K S
COXSACKIE	K AA K S AE K IY
COYANOSA	K OW Y AE N AH S AH
COYVILLE	K OW Y V IH L
CP	S IY P
CPW	S IY P IY W
CR	S IY R
CRACKEN	K R AE K AH N
CRAFTERS	K R AE F T ER Z
CRAFTSBURY	K R AE F T S B EH R IY
CRAGFORD	K R AE G F OW R D
CRAGWOOD	K R AE G W UH D
CRAIGMONT	K R EY G M AH N T
CRAIGSVILLE	K R EY G S V AH L
CRAIGVILLE	K R EY G AH L
CRAMERTON	K R AE M ER T AH N
CRANBURY	K R AE N B Y AH R IY
CRANDON	K R AE N D AH N
CRANESVILLE	K R AH N EH Z AH L
CRANFILLS	K R AE N F AH L Z
CRARYVILLE	K R AE R AH V AH L
CRAWFORDVILLE	K R AH F AO R D AH L
CRAYNOR	K R EY N AH R
CREAMRIDGE	K R IY M R IH JH
CREEDE	K R IY D
CREEDMOOR	K R IY D M UH R
CREEDMOORE	K R IY D M AH R
CREEDMORE	K R IY D M AH R
CREEKSIDE	K R IY K S AY D
CREOLA	K R IY AH L AH
CRES	K R Z
CRESAPTOWN	K R EH S AH P T OW N
CRESBARD	K R EH Z AH R D
CRESCENTA	K R EH S EH N T AH
CRESCO	K R EH S OW
CRESSKILL	K R EH S AH L
CRESSMONT	K R EH S M AH N T
CRESSONA	K R EH S AH N AH
CRESTHAVEN	K R EH S T HH EY V AH N
CRESTHILL	K R EH S T HH IH L
CRESTLINE	K R EH S T L AY N
CRESTON	K R EH S T AO N
CRESTVIEW	K R EH S T V Y UW
CRESTWATER	K R EH S T W AO T ER
CRESTWOOD	K R EH S T W UH D
CREVE	K R IY V
CRIDERS	K R IH D AH R Z
CRIDERSVILLE	K R AH D AH R S V AH L
CRIMORA	K R IH M AH R AH
CRISFIELD	K R AY Z F IY L D
CRISPI	K R IH S IY
CRK	S IY AA R K
CROCHERON	K R AA CH AH R AH N
CROCKETTS	K R AA K EH T S
CROES	K R OW Z
CROMBERG	K R AA M B AH R G
CROMMELIN	K R AA M AH L AH N
CRONSTON	K R AA N S T AH N
CROOKSVILLE	K R UH K S V AH L
CROPSEYVILLE	K R AA P S EY V AH L
CROPWELL	K R AA P W EH L
CRORY	K R AA R IY
CROSBYTON	K R AA Z AH T AH N
CROSSHILL	K R AO S HH IH L
CROSSLAKE	K R AO S L EY K
CROSSROA	K R AA S R OW AH
CROSSWAY	K R AO S W EY
CROSSWICKS	K R AO S W IH K S
CROTHERSVILLE	K R AH TH AH R S V AH L
CROTON	K R AA T AH N
CROTONA	K R AA T AH N AH
CROWHEART	K R OW HH AA R T
CROWNPOINT	K R AW N P OY N T
CROWNSVILLE	K R OW N S V AH L
CROYDON	K R OY D AH N
CRSE	K R S
CRT	S IY AA R T
CRUCIS	K R UW S AH S
CRUMMIES	K R AH M IY Z
CRUMROD	K R AH M R AH D
CRYDERS	K R IH D AH R Z
CRYSTALAIRE	K R IH S T AH L AH AY ER
CT.	S IY T IY
CTR	S IY T IY R
CTR.	S IY T IY AA R
CTY	K T AY
CUBBERLY	K AH B ER L IY
CUBERO	K Y UW B AH R OW
CUBLER	K AH B L AH R
CUCAMONGA	K Y UW K AH M AA N G AH
CUCHARA	K AH CH AH R AH
CUCHILLO	K AH CH IH L OW
CUDDEBACKVILLE	K AH D AH B AE K V AH L
CULDESAC	K AH L D AH S AH K
CULLEOKA	K AH L IY AH K AH
CULLODEN	K AH L AH D AH N
CULLOWHEE	K AH L OW IY IY
CULOTTA	K Y UW L AA T AH
CUMLEY	K AH M L IY
CUNDIYO	K AH N D IY AY OW
CUNE	K Y UW N
CURLEW	K AH R L UW
CURRIDEN	K ER AH D AH N
CURRITUCK	K AH R AH T AH K
CURRYVILLE	K AH R AH V AH L
CURWENSVILLE	K AH R W EH N S V AH L
CURZON	K AH R Z AH N
CUSSETA	K AH S AH T AH
CUSTAR	K AH S T AH R
CUTCHENVILLE	K AH CH EH N V AH L
CUTCHOGUE	K AH CH AH G
CUTSHIN	K AH T SH IH N
CUTTINGSVILLE	K AH T IH N G S V AH L
CUTTYHUNK	K AH T IY HH AH NG K
CUYAMA	K Y UW AY AH M AH
CV	S IY V
CYGNET	S IH G N AH T
CYNTHIANA	S IH N TH IY AH N AH
D.M.L.	D IY EH M EH L
DABNEYS	D AE B N EY Z
DACOMA	D AE K AH M AH
DACONO	D AE K AH N OW
DACULA	D AE K Y UW L AH
DADEVILLE	D AE D AH V AH L
DAFTER	D AE F T AH R
DAGSBORO	D AE G S B AH R OW
DAHINDA	D AH HH IH N D AH
DAHLONEGA	D AH L AA N AH G AH
DAINGERFIELD	D EY N JH AH R F IY L D
DAIRYLAND	D EH R IY L AE N D
DAISYTOWN	D EY Z IY T AW N
DALBO	D AE L B OW
DALEHAM	D EY L HH AE M
DALEMERE	D EY L M IH ER
DALEVILLE	D AE L AH V AH L
DALHART	D AE L HH AH R T
DALLES	D AO L Z
DALMATIA	D AE L M EY SH IY AH
DALNY	D AE L N IY
DAMAR	D EY M ER
DAMARISCOTTA	D AE M AH R AH S AA T AH
DAMMERON	D AE M ER AO N
DANBURG	D AE N B AH R G
DANEVANG	D AE N AH V AH NG
DANIELSVILLE	D EY N IY L S V AH L
DANNEBROG	D AE N EH B R AH G
DARDANELLE	D AA R D AH N AH L
DARFORK	D AA R F AH R K
DARNESTOWN	D AA R N AH S T OW N
DASSEL	D AE S AH L
DATELAND	D EY T L AE N D
DATIL	D AE T AH L
DATTO	D AE T OW
DAVELLA	D AH V EH L AH
DAVEN	D EY V AH N
DAVIDSONVILLE	D AE V AH D S AA N V AH L
DAVIDSVILLE	D AH V IH D S V AH L
DAVISBORO	D AH V IH Z AH R OW
DAVISPORT	D AH V IH S AH R T
DAVISTON	D AH V IH S T AH N
DAVISTOWN	D AE V AH S T OW N
DAVISVILLE	D AH V IH Z AH L
DAVIT	D EY V AH T
DAYHOIT	D EY HH OY T
DAYKIN	D EY K IH N
DAYNA	D EY N AH
DAYSVILLE	D EY Z AH L
DAYVILLE	D EY V AH L
DC	D IY S IY
DEANSBORO	D IY AE N S B AH R OW
DEATSVILLE	D IY AE T S V AH L
DEAVILLE	D IY AE V AH L
DEBARY	D IY B IY EH R IY
DECATOUR	D AH K AE T AH R
DECATURVILLE	D AH K AH T AH R V AH L
DECKERS	D IY S ER Z
DECKERVILLE	D IH K AH R V AH L
DECLO	D IH K L OW
DECORAH	D IH K AH R AE
DEEPDALE	D IY P D EY L
DEEPDENE	D IY EH P D IY N
DEEPSTEP	D IY P S T EH P
DEERBROOK	D IH ER B R UH K
DEERTON	D IH ER T AH N
DEERWOOD	D IH ER W UH D
DEETH	D IY AH TH
DEHIRSCH	D AH HH AH R S
DEHUE	D IY HH Y UW
DEISIUS	D IY IH S AY AH S
DEKOVEN	D AH K OW V AH N
DELACORTE	D AH L AE K AH R T
DELAMERE	D AH L EY M AH R
DELANCO	D AH L AE NG K OW
DELANSON	D AH L AE N S AH N
DELAPLAINE	D AH L AE P L EY N
DELAPLANE	D IY L AE P L EY N
DELAWANNA	D AH L AO AE N AH
DELEFIELD	D IH L AH F IY L D
DELEVAN	D AH L IY V AH N
DELLROY	D EH L R OW IY
DELLS	D EH L Z
DELLWOOD	D EH L W UH D
DELMITA	D IH L M IH T AH
DELOIT	D AH L OY T
DELOTTO	D AH L AA T OW
DELPHOS	D IH L F AA Z
DELSEA	D IH L S IY
DELTAVILLE	D IH L T AE V AH L
DELTON	D IH L T AA N
DELWIT	D IH L W IH T
DEMA	D AH M AA
DEMEREST	D IY M IH ER AH S T
DEMOPOLIS	D AH M AA P AH L AH S
DEMOSSVILLE	D AH M AA S V AH L
DEMOTTE	D AH M AA T
DENAIR	D EH N EH R
DENALI	D AH N AE L IY
DENDRON	D IH N D R AA N
DENFIELD	D EH N F IY L D
DENHOFF	D IH N HH AA F
DENMEAD	D EH N M IY D
DENNEHOTSO	D IH N AH HH AA T S OW
DENNYSVILLE	D IH N IH Z AH L
DENOW	D AH N OW
DENVILLE	D IH N V IH L
DEORA	D IY AO R AH
DEPEYSTER	D AH P EY S T AH R
DEPOE	D AH P OW
DEPTFORD	D IH T AO R D
DEQUINCY	D IY K W IH N S IY
DEREIMER	D IH R IY AY M AH R
DERONDA	D AH R AA N D AH
DEROUSE	D IY R AW Z
DERWOOD	D IH R W UW D
DESARC	D AH S AA R K
DESBROSSES	D IH S B R AA S AH Z
DESCANSO	D IH S AE N S OW
DESDEMONA	D IH S D EH M AH N AH
DESEREE	D AH S AH R IY IY
DESERRE	D AH S EH R
DESLOGE	D IH S L OW JH
DEVANNEY	D AH V AE N IY
DEVEL	D AH V EH L
DEVONIA	D AH V OW N Y AH
DEWEYVILLE	D AH W EY V AH L
DEWITTVILLE	D AH W IH T V AH L
DIALVILLE	D AY AE L V AH L
DIAMONDHEAD	D AY M AH N D HH EH D
DIDN	D IH D N
DIEN	D AY AH N
DIERAUF	D IY R AH F
DIGHTON	D AY T AH N
DIGNEY	D IH G N IY
DILLINER	D IH L IH N ER
DILLONVALE	D IH L AO N V EY L
DILLSBORO	D IH L S B AH R OW
DILLSBURG	D IH L S B AH R G
DIMONDALE	D IH M AO N D EY L
DINGMANS	D IH N G M AH N Z
DINTREE	D IH N T R IY
DINUBA	D IH N Y UW B AH
DISCALA	D IH S AE L AH
DISOSWAY	D IH S AA S W EY
DISPUTANTA	D IH S P UH T AE N T AH
DITMAS	D IH T M AH Z
DIVITT	D IH V AH T
DIXFIELD	D IH K S IY L D
DIXIANA	D IH K S IY AH N AH
DIXMONT	D IH K S M AH N T
DIZNEY	D IH Z N IY
DMV	D IY EH M V
DODDSVILLE	D AA D S V AH L
DODGEVILLE	D AA JH AH V AH L
DODGEWOOD	D AA JH W UH D
DODWORTH	D AA D W AH R TH
DOERUN	D OW R AH N
DOESN	D OW AH Z N
DOGPATCH	D AO G P AE CH
DOLA	D OW L AH
DOLGEVILLE	D OW L JH AH V AH L
DOLLARWAY	D AA L ER W EY
DOLLVILLE	D AA L V AH L
DOMI	D OW M IY
DONALDSONVILLE	D AA N AH L D S AA N V AH L
DONALSONVILLE	D AA N AH L S AA N V AH L
DONATUS	D OW N EY T AH S
DONCASTER	D AA N K AE S T ER
DONEGAL	D AH N G AE L
DONGAN	D AA N G AH N
DONGOLA	D AA N G AH L AH
DONIE	D AA N IY
DONIPHAN	D AA N AH F AH N
DONNELLON	D AA N EH L AH N
DONNELLSON	D AA N EH L S AH N
DONORA	D AA N AH R AH
DONOUGH	D AA N UW
DOOLE	D UW L
DOON	D UW AO N
DOONE	D UW N
DORIGO	D AO R AH G OW
DORIT	D AO R AH T
DORMANS	D AO R M AH N Z
DORMANSVILLE	D AO R M AE N S V AH L
DORNSIFE	D AO R N S AY F
DORP	D AO R P
DOUBS	D AW B Z
DOUGLASSVILLE	D AW G L AE S V AH L
DOUGLASTON	D AW G L AE S T AH N
DOUGLASVILLE	D AW G L AE Z AH L
DOUSMAN	D AW Z M AH N
DOVRAY	D AA V R EY IY
DOWAGIAC	D OW EY JH IY AH K
DOWELLTOWN	D UW W EH L T AW N
DOWNIEVILLE	D OW N IY V AH L
DOWNSVILLE	D OW N S V AH L
DOWS	D AW Z
DOXSEY	D AA K S IY
DOYERS	D OW IY ER Z
DOYLESBURG	D OY L EH Z AH R G
DOYLESTOWN	D OY L AH S T OW N
DOYLINE	D OW IY L AY N
DRACUT	D R AE K AH T
DRAKESBORO	D R AH K EH Z AH R OW
DRAKESVILLE	D R AH K EH Z AH L
DRASCO	D R AE S OW
DRAVOSBURG	D R AH V AA Z AH R G
DRAYDEN	D R EY D AH N
DREISER	D R IY AH S AH R
DREWRYVILLE	D R UW R AH V AH L
DREWSEY	D R UW Z IY
DRIPROCK	D R IH P R AA K
DRUMGOOLE	D R AH M G UW L
DRUMORE	D R AH M OW R
DRYFORK	D R AY F AO R K
DRYHILL	D R AY HH IH L
DUANESBURG	D Y UW AH N EH Z AH R G
DUBRE	D Y UW B AH R
DUCHESNE	D AH CH AH Z N
DUERER	D UW ER ER
DUETTE	D UW EH T
DUGGINSVILLE	D AH JH IH N S V AH L
DUGSPUR	D AH G S P ER
DUGWAY	D AH G W EY
DUHRING	D AH R AH NG
DULANCEY	D Y UW L AE N S IY
DULTYS	D AH L T AH Z
DULZURA	D AH L Z AH R AH
DUMFRIES	D AH M F R AY Z
DUNBARTON	D AH N B AA R T AH N
DUNCANNON	D AH N K AE N AH N
DUNCANSVILLE	D AH NG K AE N S V AH L
DUNCANVILLE	D AH NG K AE N V AH L
DUNCOMB	D AH N K OW M
DUNDALK	D AH N D AH K
DUNDAR	D AH N D AH R
DUNELLEN	D Y UW N EH L AH N
DUNFERMLINE	D AH N F AH R M L AY N
DUNGANNON	D AH N G AE N AH N
DUNHAMS	D AH N HH AE M Z
DUNKERHOOK	D AH NG K ER HH UH K
DUNKERTON	D AH NG K ER T AH N
DUNLAWTON	D AH N L AO T AH N
DUNLIN	D AH N L AH N
DUNLOW	D AH N L OW
DUNMOR	D AH N M AH R
DUNMORE	D AH N M AH R
DUNNEGAN	D AH N AH G AH N
DUNNVILLE	D AH N V AH L
DUNSMUIR	D AH N S M UW R
DUNSTABLE	D AH N S T EY B AH L
DUPO	D Y UW P OW
DURANTS	D UH R AH N T S
DURGESS	D AH R JH AH S
DURHAMVILLE	D AH R AE M V AH L
DURNESS	D AH R N AH S
DUSHORE	D AH SH AH R
DUSON	D Y UW S AH N
DUSTAN	D AH S T AH N
DUTCHESS	D AH CH AH S
DUTCHTOWN	D AH CH T AW N
DUXBURY	D AH K S B Y AH R IY
DUYVIL	D Y UW AH V AH L
DUZER	D Y UW Z AH R
DVWY	D V W AY
DYERSBURG	D AY AH R S B AH R G
DYERSVILLE	D AY AH R S V AH L
DYNE	D AY N
DYRE	D AY R
EAGLETOWN	IY G AH L T AW N
EAGLEVILLE	IY G L AH V AH L
EARLETON	IH ER L EH T AO N
EARLEVILLE	AH R L AH V AH L
EARLHAM	ER L HH AE M
EARLIMART	ER L IH M AA R T
EARLING	IH ER L IH NG
EARLINGTON	IH ER L IH NG T AH N
EARLSBORO	AH R L S B AH R OW
EARLTON	ER L T AH N
EARLVILLE	AH R L V AH L
EARLYSVILLE	AH R L IH Z AH L
EASTABOGA	IY S T AE B AH G AH
EASTAMPTON	IY S T AE M P T AH N
EASTANOLLEE	IY S T AH N AH L IY IY
EASTBOROUGH	IY S T B ER OW
EASTBROOK	IY S T B R UH K
EASTCHESTER	IY S T CH EH S T ER
EASTENTRY	IY S T AH N T R IY
EASTFORD	IY S T F OW R D
EASTGATE	IY S T G EY T
EASTMANS	IY S T M AE N Z
EASTPOINTE	IY S T OY N T
EASTPORT	IY S T P OW R T
EASTSOUND	IY S T S AW N D
EATONTON	IY T AO N T AH N
EATONTOWN	IY T AO N T AW N
EATONVILLE	IY T AA N V AH L
EBBITTS	EH B AH T S
EBENSBURG	AH B EH N S B AH R G
ECHOLA	EH CH AH L AH
ECKELSON	EH K EH L S AH N
ECKENHOFF	EH K EH N HH AH F
ECKERTY	EH K EH R T IY
ECLETO	EH K L AH T OW
ECORSE	EH K AH R S
EDDYVILLE	EH D AH V AH L
EDENVILLE	AH D EH N V AH L
EDENWALD	AH D EH N W AH L D
EDERLE	EH D AH R L
EDGARD	EH JH AH R D
EDGARTOWN	EH JH ER T AW N
EDGEFIELD	EH JH F IY L D
EDGEGROVE	EH JH G R OW V
EDGEHILL	EH JH HH IH L
EDGEMERE	EH JH M IH ER
EDGEMONT	EH JH AH M AH N T
EDGEMOOR	EH JH M UH R
EDGERSTONE	EH JH ER S T OW N
EDGEVIEW	EH JH V Y UW
EDGEWATER	EH JH W AO T ER
EDINBURG	AH D IH N B AH R G
EDISONIA	EH D AH S OW N Y AH
EDMESTON	EH D M EH S T AH N
EDMORE	EH D M AH R
EDOM	EH D AH M
EDON	EH D AH N
EDSTONE	EH D S T OW N
EDWALL	EH D W AH L
EDWARDSBURG	EH D W AO R D S B AH R G
EDWARDSPORT	EH D W ER D Z P OW R T
EDWARDSVILLE	EH D W AO R D S V AH L
EEK	IY K
EFFINGTON	EH F IH N G T AH N
EFLAND	EH F L AH N D
EGEGIK	EH JH AH JH AH K
EGGERTS	EH JH AH R T S
EGLON	EH G L AH N
EGMONT	EH G M AH N T
EGNAR	EH G N AH R
EGREMONT	EH G R AH M AH N T
EGRIT	EH G R AH T
EIELSON	IY EH L S AH N
EKALAKA	AH K AE L AH K AH
EKRON	EH K R AH N
EKWOK	EH K W AH K
ELBA	EH L B AH
ELBERFELD	EH L B AH R F AH L D
ELBERNE	EH L B AH R N
ELBERON	EH L B AH R AH N
ELBERTON	EH L B AH R T AH N
ELBERTSON	EH L B AH R T S AH N
ELBING	EH L B AH NG
ELBRIDGE	EH L B R AH JH
ELBURN	EH L B AH R N
ELCHO	EH L CH OW
ELDERIDGE	EH L D AH R AH JH
ELDERT	EH L D AH R T
ELEELE	IY L IY L
ELERON	EH L AH R AH N
ELEVA	EH L AH V AH
ELGOOD	EH L G UW D
ELIDA	EH L AH D AH
ELIM	EH L AH M
ELIZABETHTON	EH L AH Z AH B EH TH T AH N
ELIZABETHVILLE	EH L AH Z AH B EH TH V AH L
ELIZAVILLE	AH L IH Z AH V AH L
ELKA	EH L K AH
ELKADER	EH L K EY D ER
ELKFORK	EH L K F AO R K
ELKLAND	EH L K L AE N D
ELKMONT	EH L K M AH N T
ELKPORT	EH L K P OW R T
ELKVILLE	EH L K V AH L
ELKWOOD	EH L K W UH D
ELLABELL	EH L AH B AH L
ELLAMORE	EH L AH M AH R
ELLAVILLE	EH L AH V AH L
ELLEEN	EH L IY AH N
ELLENBORO	EH L EH N B AH R OW
ELLENDALE	EH L AH N D EY L
ELLENSBURG	EH L EH N S B AH R G
ELLENTON	EH L EH N T AH N
ELLENVILLE	EH L EH N V AH L
ELLERSLIE	EH L AH R S L AY
ELLETTSVILLE	EH L EH T S V AH L
ELLICOTTVILLE	EH L AH K AA T V AH L
ELLIOTTSBURG	EH L IY AA T S B AH R G
ELLISBURG	EH L IH Z AH R G
ELLISVILLE	EH L IH Z AH L
ELLMYER	EH L M AY AH R
ELLOREE	EH L AH R IY IY
ELLPORT	EH L P AH R T
ELLSINORE	EH L Z IH N OW R
ELLSTON	EH L Z T AH N
ELLWELL	EH L W AH L
ELMARY	EH L M EH R IY
ELMATON	EH L M AH T AH N
ELMBANK	EH L M B AE NG K
ELMDALE	EH L M D EY L
ELMORA	EH L M AH R AH
ELMROCK	EH L M R AA K
ELMTOWNE	EH L M T OW N
ELMTREE	EH L M T R IY
ELON	EH L AH N
ELORA	EH L AH R AH
ELSAH	EH L S AH
ELSEMERE	EH L S IY M AH R
ELSIN	EH L Z IH N
ELSMAN	EH L Z M AE N
ELSMERE	EH L Z M IH ER
ELSMORE	EH L S M AH R
ELTINGE	EH L T AH N JH
ELTINGVILLE	EH L T IH N G AH L
ELTOPIA	EH L T OW P IY AH
ELUM	EH L AH M
ELVASTON	EH L V AE S T AH N
ELVERSON	EH L V AH R S AH N
ELVERTA	EH L V AH R T AH
ELVERTON	EH L V AH R T AH N
ELVINS	EH L V AH N Z
ELYSBURG	AH L IH Z AH R G
ELYSIAN	AH L IH Z IY AH N
EMANU	AH M AE N UW
EMBDEN	EH M B D AH N
EMBUDO	IH M B Y UW D OW
EMDEN	IH M D EH N
EMELLE	AH M EH L
EMERADO	IH M IH R AH D UW
EMERIC	AH M EH R AH K
EMINGTON	EH M IH NG T AH N
EMLEN	EH M L AH N
EMLENTON	IH M L EH N T AO N
EMMETSBURG	IH M EH T S B AH R G
EMMITSBURG	IH M IH T S B AH R G
EMMONAK	IH M AA N AH K
EMP.	EH M P
ENCINAL	IH N S AY N AH L
ENCINITAS	IH N S IH N AH T AH Z
ENDOR	EH N D ER
ENDVIEW	EH N D V Y UW
ENDWELL	EH N D W EH L
ENGADINE	IH N G AH D AY N
ENGARD	IH N G AA R D
ENGLESIDE	IH N G L AH S AY D
ENGLEVALE	IH N G L AH V EY L
ENGLISHTOWN	IH N G L IH SH T OW N
ENNICE	EH N AY S
ENNING	EH N IH NG
ENON	EH N AO N
ENOREE	EH N OW R IY
ENOSBURG	AH N AA Z AH R G
ENS	EH N Z
ENTIAT	IH N T AY AH T
ENTR	EH N T R
ENTRANC	IH N T R AE NG K
ENUMCLAW	AH N AH M K L AH
ENVILLE	IH N V IH L
EOLA	IY AH L AH
EOLIA	IY OW L Y AH
EPHRATA	EH F R AH T AH
EPWORTH	EH P W AH R TH
EQUINUNK	EH K W AH N AH NG K
ERASTINA	AH R AE S T AH N AH
ERATH	IH R AH TH
ERBACON	AH R B AH K AH N
ERIAL	IY R IY AH L
ERICO	EH R AH K OW
ERIEVILLE	IY R IY V AH L
ERLI	AH R L IY
ERNSTON	AH R N S T AH N
ERNUL	AH R N AH L
ERUDO	AH R UW D OW
ERWINNA	AH R W IH N AH
ERWINVILLE	AH R W IH N V AH L
ESBON	EH Z AH N
ESCALON	EH S AH L AH N
ESKO	EH S OW
ESMAC	EH Z M AH K
ESMONT	EH Z M AH N T
ESPARTO	EH S AA R T OW
ESPERANCE	EH S AH R AH N S
ESPOMA	EH S AH M AH
ESPYVILLE	EH S AH V AH L
ESSEXVILLE	EH S EH K S V AH L
ESTACADA	EH S T AE K AH D AH
ESTANCIA	EH S T AE N CH IY AH
ESTAUGH	EH S T AH
ESTERBROOK	EH S T ER B R UH K
ESTERO	EH S T AH R OW
ESTHERVILLE	EH S TH AH R V AH L
ESTILLFORK	EH S T IH L F AH R K
ETHELSVILLE	AH TH EH L S V AH L
ETHETE	AH TH IY T
ETIWANDA	EH T AH W AA N D AH
ETLAN	EH T L AH N
ETOILE	EH T OW AH L
ETOWAH	EH T OW AH
ETS	EH T S
ETTEN	EH T AH N
ETTRICK	EH T R AH K
EUCHA	Y UW CH AH
EUDOWOOD	Y UW D OW UW D
EUFAULA	Y UW F AH L AH
EULESS	Y UW L AH S
EULNER	Y UW L N AH R
EUTAW	Y UW T AH
EUTAWVILLE	Y UW T AH V AH L
EVANSDALE	EH V AH N S D EY L
EVART	EH V AH R T
EVENSVILLE	AH V EH N S V AH L
EVERDELL	EH V ER D EH L
EVERIT	EH V AH R AH T
EVESHAM	IY V SH AE M
EVINGTON	IY V IH NG T AH N
EVONA	EH V AH N AH
EWA	Y UW AH
EWINGVILLE	Y UW IH N G AH L
EXCELLO	IH K S EH L OW
EXELAND	IH G Z EH L AH N D
EXIRA	IH G Z IH R AH
EXMORE	IH K S M AO R
EXT	EH K S T
EXTENS	EH K S T EH N Z
EY	IY IY
EYCK	EY K
EYLANDT	EY L AH N D T
EYLENDT	EY L AH N D T
EZEL	EH Z AH L
F.LEWIS	EH F L UW AH S
FA	F AA
FABIUS	F AE B AY AH S
FABYAN	F AE B AY AH N
FACTORYVILLE	F AE K T AO R AH V AH L
FADAM	F AE D AH M
FAIRBORN	F EH R B AO R N
FAIRBURY	F EH R B EH R IY
FAIRCHANCE	F EH R CH AE N S
FAIRDALE	F EH R D EY L
FAIRDEALING	F EH R D IY L IH NG
FAIRGROVE	F EH R G R OW V
FAIRHOPE	F EH R HH OW P
FAIRLAND	F EH R L AE N D
FAIRLEE	F EH R L IY
FAIRMOUNT	F EH R M AW N T
FAIROAKS	F EH R OW K S
FAIRPLAY	F EH R P L EY
FAIRPORT	F EH R P OW R T
FAIRTON	F EH R T AH N
FAIRVILLA	F EH R V IH L AH
FAITOUTE	F EY T AH Y UW T
FAL	F AE L
FALFURRIAS	F AE L F AH R IY AH Z
FALKVILLE	F AE L K V AH L
FALLBROOK	F AO L B R UH K
FALLENTIMBER	F AE L AH N T IH M B ER
FALLSBURG	F AE L S B AH R G
FALLSTON	F AO L Z T AH N
FALTBUSH	F AE L T B AH SH
FALUN	F AE L AH N
FANNETTSBURG	F AE N EH T S B AH R G
FANROCK	F AE N R AA K
FANWOOD	F AE N W UH D
FARGEVILLE	F AA R JH AH V AH L
FARISITA	F AH R IH S AH T AH
FARISTA	F AH R IH S T AH
FARLINGTON	F AA R L IH NG T AH N
FARMDALE	F AA R M D EY L
FARMERSBURG	F AA R M AH R S B AH R G
FARMERSVILLE	F AA R M AH R S V AH L
FARMERVILLE	F AA R M AH R V AH L
FARMHAVEN	F AA R M HH EY V AH N
FARMINGDAL	F AA R M IH N G D AH L
FARMINGVILLE	F AA R M IH N G AH L
FARMVILLE	F AA R M V AH L
FARNHAMVILLE	F AA R N HH AE M V AH L
FARRADAY	F AE R AE D EY IY
FARVIEW	F AA R V Y UW
FAUNSDALE	F AO N S D EY L
FAYANN	F EY AH N
FAYETTEVILL	F EY EH T AH V AH L
FDR	EH F D IY R
FEASTERVILLE	F IY S T AH R V AH L
FEATHERTREE	F EH DH ER T R IY
FEDERALSBURG	F EH D AH R AE L S B AH R G
FELDMEYERS	F EH L D M EY AH R Z
FELIDA	F EH L AH D AH
FELLSMERE	F EH L Z M IH ER
FENELTON	F AH N EH L T AH N
FENNVILLE	F EH N V AH L
FERNLEY	F AH R N L IY
FERNSIDE	F ER N S AY D
FERNWOOD	F ER N W UH D
FERRELLSBURG	F EH R EH L S B AH R G
FERRELVIEW	F EH R AH L V IY W
FERRISBURG	F EH R IH Z AH R G
FERRUM	F EH R AH M
FERRYVILLE	F EH R AH V AH L
FEURA	F Y UH R AH
FIATT	F AY AH T
FICARELLE	F IH K AH R AH L
FIDDLETOWN	F IH D AH L T AW N
FIELDALE	F IY L D EY L
FIELDMEYERS	F IY L D M EY AH R Z
FIELDON	F IY L D AO N
FIELDSTON	F IY L D Z T AH N
FIELDSTONE	F IY L D S T OW N
FIELDTON	F IY L D T AH N
FIELDWAY	F IY L D W EY
FIGUREA	F IH G Y UH R IY AH
FILIPE	F AH L AY P
FILLAT	F IH L AH T
FINCASTLE	F IH N K AE S AH L
FINCHLEY	F IH NG K L IY
FINCHVILLE	F IH NG K V AH L
FINDERNE	F IH N D AH R N
FINGAL	F IH N G AE L
FINLAW	F IH N L AO
FINLEYVILLE	F IH N L EY V AH L
FIRCREST	F ER K R EH S T
FIREMENS	F AY ER M EH N Z
FIRESTEEL	F AY ER S T IY L
FIRMENCH	F AH R M AH N CH
FIRMENICH	F AH R M AH N AH CH
FIRWOOD	F ER W UH D
FISHERVILLE	F AH SH AH R V AH L
FISHTAIL	F IH SH T EY L
FISHTRAP	F IH SH T R AE P
FISKDALE	F IH S D EY L
FISTY	F IH S T IY
FITTSTOWN	F IH T S T OW N
FITZRANDOLPH	F IH T S R AH N D OW L F
FLAMBEAU	F L AE M B IY UW
FLANDREAU	F L AE N D R IY UW
FLATIRON	F L AE T AY ER N
FLATONIA	F L AH T OW N Y AH
FLATWOODS	F L AE T W UH D Z
FLAXVILLE	F L AE K S V AH L
FLEMINGSBURG	F L AH M IH N G S B AH R G
FLENSBURG	F L EH N S B AH R G
FLINTON	F L IH N T AO N
FLINTRIDGE	F L IH N T R IH JH
FLINTVILLE	F L IH N T V AH L
FLOMATON	F L AA M AH T AH N
FLOMOT	F L AA M AH T
FLOODWOOD	F L AH D W UH D
FLORAHOME	F L OW R AH HH OW M
FLORALA	F L AO R AH L AH
FLORESVILLE	F L AH R EH Z AH L
FLORHAM	F L AO R AH M
FLORIEN	F L OW R IY AH N
FLORISSANT	F L OW R IY Z AH N T
FLORISTON	F L OW R IH S T AO N
FLOSSMOOR	F L AA S M OW AH R
FLOURTOWN	F L AW ER T AW N
FLOVILLA	F L AH V IH L AH
FLOWEREE	F L AW ER IY
FLOYDADA	F L OW IY D AA D AA
FLOYDS	F L OY D Z
FLUVANNA	F L UW V AE N AH
FO	F OW
FOCH	F AA CH
FOGELSVILLE	F AH JH EH L S V AH L
FOLA	F OW L AH
FOLCROFT	F OW L K R AH F T
FOLIN	F AA L AH N
FOLKSTON	F OW K S T AH N
FOLLANSBEE	F AA L AH N S B IY IY
FOMBELL	F AA M B AH L
FONDE	F AA N D
FONTANELLE	F AA N T AH N AH L
FOOSLAND	F UW Z L AH N D
FORBELL	F AO R B EH L
FORBESTOWN	F AO R B EH S T OW N
FORBING	F AO R B IY IH NG
FORC	F AO R K
FORDLAND	F OW R D L AE N D
FORDOCHE	F AO R D AH CH
FORDSVILLE	F AO R D S V AH L
FORDVILLE	F AO R D AH L
FORENOON	F OW R N UW N
FORES	F OW R Z
FORESTBURG	F AH R EH S T B AH R G
FORESTBURGH	F AH R EH S T B AH R
FORESTDALE	F AO R AH S T D EY L
FORESTGROVE	F AO R AH S T G R OW V
FORESTHILL	F AO R AH S T HH IH L
FORESTON	F AO R AH S T AO N
FORESTPORT	F AO R AH S T P OW R T
FORGAN	F AO R G AH N
FORISTELL	F OW R IY Z T EH L
FORKLAND	F AO R K L AE N D
FORKSVILLE	F AO R K S V AH L
FORLEY	F AO R L IY
FORNELIUS	F AO R N EH L AY AH S
FORRESTON	F AO R EH S T AO N
FORTESCUE	F AO R T EY Z K Y UW
FORTVILLE	F AO R T V AH L
FOSSTON	F AA S T AH N
FOSTERDALE	F AO S T ER D EY L
FOSTERTOWN	F AO S T ER T AW N
FOSTORIA	F AA S T AO R IY AH
FOUKE	F AW K
FOUNTAINTOWN	F AW N T AH N T AW N
FOUNTAINVILLE	F AW N T EY N V AH L
FOUNTAYNE	F AW N T EY N
FOURATT	F AH R AH T
FOURCHE	F AH R CH
FOWBELSBURG	F OW B EH L S B AH R G
FOWLERTON	F AW L ER T AH N
FOWLERVILLE	F OW L AH R V AH L
FOXBURG	F AA K S B AH R G
FOXCROFT	F AA K S K R AO F T
FOXHOLM	F AA K S OW L M
FOXHOME	F AA K S HH OW M
FOXMOOR	F AA K S M UH R
FOXTON	F AA K S T AH N
FR	EH F R
FRACKVILLE	F R AE K V AH L
FRANCESTOWN	F R AE NG K AH S T OW N
FRANCESVILLE	F R AE N S EH Z AH L
FRANCI	F R AE N S IY
FRANCISVIL	F R AE N S IH Z AH L
FRANCONIA	F R AE NG K OW N Y AH
FRANKENMUTH	F R AE NG K EH N M AH TH
FRANKEWING	F R AE NG K Y UW IH NG
FRANKFORD	F R AE NG K F OW R D
FRANKLINTON	F R AE NG K L AH N T AH N
FRANKSTON	F R AE NG K S T AH N
FRANKSVILLE	F R AE NG K S V AH L
FRANKTON	F R AE NG K T AH N
FRANKTOWN	F R AE NG K T AW N
FRANKVILLE	F R AE NG K V AH L
FRAUNCES	F R AO N S AH Z
FRAZEYSBURG	F R EY Z EY Z AH R G
FRAZIERS	F R EY Z IY R Z
FREDERICKTOWN	F R AH D EH R AH K T OW N
FREDON	F R EH D AH N
FREDONIA	F R AH D OW N Y AH
FREEVILLE	F R IY V AH L
FREEWATER	F R IY W AO T ER
FREISTATT	F R IY S T AH T
FRELINGHUYSEN	F R AH L IH N Y UW AH Z AH N
FRENCHMANS	F R EH N CH M AE N Z
FRENCHTOWN	F R EH N CH T AW N
FRENCHVILLE	F R EH NG K V AH L
FREWSBURG	F R UW S B AH R G
FRIANT	F R AY AH N T
FRIEDENS	F R AY D AH N Z
FRIEDHEIM	F R IY D HH IY M
FRIENDLYS	F R EH N D L IY Z
FRIENDSVILLE	F R IY N D S V AH L
FRIENDSWOOD	F R EH N D Z W UH D
FRIESBURG	F R IY Z AH R G
FRIO	F R AY OW
FROGMORE	F R AA G M AH R
FROHNA	F R AA N AH
FROID	F R OY D
FROMBERG	F R AA M B AH R G
FRONTENAC	F R AA N T AH N AH K
FROSTBURG	F R AA S T B AH R G
FROSTHOFFER	F R AA S TH AA F AH R
FROSTPROOF	F R AO S T P R UW F
FRUITA	F R UW T AH
FRUITDALE	F R UW T D EY L
FRUITHURST	F R UW TH AH R S T
FRUITLAND	F R UW T L AE N D
FRUITPORT	F R UW T P OW R T
FRUITVALE	F R UW T V EY L
FRYBURG	F R IH B AH R G
FRYEBURG	F R AY AH B AH R G
FT	EH F T
FT.	EH F T IY
FTELEY	F T IY L IY
FUGET	F Y UW JH AH T
FULDA	F UH L D AH
FULLING	F UH L IH NG
FULSHEAR	F UH L SH IY AH R
FULTONHAM	F UH L T AA N HH AH M
FULTONVILLE	F UH L T AA N V AH L
FUNIAK	F Y UW N IY AH K
FUNICULAR	F Y UW N IH S Y AH L AH R
FURLER	F ER L ER
FURMANVILLE	F AH R M AE N V AH L
FURN	F AH R N
FURNA	F AH R N AH
FUTURITY	F Y UW CH ER AH T IY
FWY	F W AY
FYCKE	F IH K
G.O.D.	JH IY OW D IY
G.S.	JH IY EH S
GAASTRA	G AA S T R AH
GABBS	G AE B Z
GACKLE	G AE K AH L
GADELL	G AE D AH L
GADSEN	G AE D S EH N
GAGES	G EY JH IH Z
GAGETOWN	G EY JH T AW N
GAHANNA	G AH HH AE N AH
GAHEYSVILLE	G AH HH EY Z AH L
GAINESBORO	G EY N EH Z AH R OW
GAINESTOWN	G EY N AH S T OW N
GALATA	G AE L AH T AH
GALATIA	G AH L EY SH IY AH
GALENTO	G AH L EH N T OW
GALESVILLE	G AH L EH Z AH L
GALETON	G EY L T AH N
GALIEN	G EY L IY AH N
GALION	G EY L Y AH N
GALIVANTS	G EY L IH V AH N T S
GALLIE	G AO L IY
GALLIPOLIS	G AE L IH P AH L AH S
GALLITZIN	G AE L IH T S AH N
GALVA	G AE L V AH
GALVASTON	G AE L V AE S T AO N
GAMALIEL	G AE M AH L IY L
GAMBELL	G AE M B AH L
GAMBIER	G AE M B AY AH R
GAMBRILLS	G AE M B R AH L Z
GANADO	G AE N AH D OW
GANDEEVILLE	G AE N D IY V AH L
GANISTER	G AH N IH S T AH R
GANSEVOORT	G AE N S AH V AH R T
GANTOWN	G AE N T OW N
GANTTOWN	G AE N T OW N
GARCIASVILLE	G AA R S IY AE Z AH L
GARDAR	G AA R D AH R
GARDENDALE	G AA R D AH N D EY L
GARDNERS	G AA R D N AH R Z
GARDNERVILLE	G AA R D N AH R V AH L
GARITA	G AE R AH T AH
GARNAVILLO	G AA R N AH V IH L OW
GARNERVILLE	G AA R N AH R V AH L
GARRATTSVILLE	G AE R AE T S V AH L
GARRETTSVILLE	G AE R EH T S V AH L
GARRYOWEN	G AE R AY OW AH N
GARYSBURG	G AH R IH Z AH R G
GARYVILLE	G AE R AH V AH L
GASBURG	G AE Z AH R G
GASCOYNE	G AE S OY N
GASPORT	G AE S P OW R T
GASQUET	G AE S AH T
GASSVILLE	G AE S V AH L
GATEHALL	G EY T HH AO L
GATEHOUSE	G EY T HH AW S
GATESVILLE	G AH T EH Z AH L
GATLINBURG	G AE T L IH N B AH R G
GATON	G AE T AH N
GATTMAN	G AE T M AH N
GAULDY	G AO L D IY
GAULEY	G EY AH L IY
GAUPP	G AO P
GAYLESVILLE	G EY L EH Z AH L
GAYLORDSVILLE	G EY L AO R D S V AH L
GAYSVILLE	G EY Z AH L
GAYVILLE	G EY V AH L
GEFF	JH EH F
GEHEE	JH EH IY IY
GEIGERICH	JH EY JH AH R AH CH
GEISMAR	JH IY Z M AH R
GELDNER	JH EH L D N AH R
GELSTON	JH EH L Z T AH N
GENESEO	JH AH N IY S IY OW
GENOLA	JH EH N AH L AH
GENTRYVILLE	JH EH N T R AH V AH L
GEPP	JH EH P
GERAUD	JH EH R AH D
GERITSEN	JH AH R IH T S AH N
GERLAW	JH AH R L AH
GERMANSVILLE	JH AH R M AE N S V AH L
GERMANTON	JH ER M AH N T AH N
GERMFASK	JH AH R M F AH S
GERRARDSTOWN	JH EH R AH R D S T OW N
GERSHEN	JH AH R SH AH N
GERTON	JH AH R T AH N
GERVIL	JH AH R V AH L
GETZVILLE	JH EH T S V AH L
GEUDA	JH UW D AH
GEYSERVILLE	JH EY S AH R V AH L
GHEENS	G IY N Z
GIAMPETRO	JH AY AH M P EH T R OW
GIANNA	JH AY AE N AH
GIBBONSVILLE	JH IH B AA N S V AH L
GIBBSBORO	JH IH B S B AH R OW
GIBBSTOWN	JH IH B S T OW N
GIBSLAND	JH IH B S L AH N D
GIBSONBURG	JH IH B S AA N B AH R G
GIBSONIA	JH IH B S OW N Y AH
GIBSONTON	JH IH B S AA N T AH N
GIBSONVILLE	JH IH B S AA N V AH L
GILBERTOWN	G IH L P ER T OW N
GILBERTS	G IH L P ER T S
GILBERTSVILLE	JH IH L B AH R T S V AH L
GILBERTVILLE	JH IH L B AH R T V AH L
GILBOA	JH IH L B OW AH
GILDFORD	G IH L D F OW R D
GILLSVILLE	JH IH L S V AH L
GILMANTON	JH IH L M AE N T AH N
GILSUM	JH IH L S AH M
GIORDAN	JH AY AO R D AH N
GIPSY	JH IH P S IY
GIRARDEAU	JH AH R AA R D IY UW
GIRARDVILLE	JH AH R AA R D AH L
GIRDLETREE	G ER D AH L T R IY
GIT	JH IH T
GLADBROOK	G L AE D B R UH K
GLADEHILL	G L AE D AH HH AH L
GLADEWATER	G L AE D Y UW AH T ER
GLADWYN	G L AE D W AH N
GLADWYNE	G L AE D W AY N
GLADY	G L AE D IY
GLARUS	G L AE R AH S
GLASFORD	G L AE S AH R D
GLASSBORO	G L AE S B AH R OW
GLASSPORT	G L AE S P OW R T
GLASTONBUR	G L AE S T AA N B AH R
GLASTONBURY	G L AE S T AA N B Y AH R IY
GLEANE	G L IY N
GLEBE	G L IY B
GLENALLEN	G L EH N AH L AH N
GLENARM	G L EH N AA R M
GLENBEULAH	G L EH N B Y UW L AH
GLENCOE	G L EH NG K OW
GLENCROSS	G L EH N K R AO S
GLENDIVE	G L EH N D AY V
GLENDO	G L EH N D UW
GLENDORA	G L EH N D AH R AH
GLENELG	G L EH N AH L G
GLENFIELD	G L EH N F IY L D
GLENFORD	G L EH N F OW R D
GLENHAVEN	G L EH N HH EY V AH N
GLENMONT	G L EH N M AH N T
GLENMOORE	G L EH N M AH R
GLENNALLEN	G L EH N AH L AH N
GLENNS	G L EH N Z
GLENNVILLE	G L EH N V AH L
GLENOLDEN	G L EH N OW L D AH N
GLENOMA	G L EH N AH M AH
GLENPOOL	G L EH N P UW L
GLENROCK	G L EH N R AA K
GLENSHAW	G L EH N SH AO
GLENSIDE	G L EH N S AY D
GLENVIL	G L EH N V AH L
GLENZ	G L EH N Z
GLN	JH IY EH L N
GLORIETA	G L AH R IY T AH
GLOUSTER	G L AW S T AH R
GLOVERSVILLE	G L AH V AH R S V AH L
GLYNCO	G L IH NG K OW
GLYNDON	G L IH N D AH N
GNADENHUTTEN	N AH D EH N HH AH T AH N
GOBLER	G OW B L AH R
GOBLES	G OW B AH L Z
GODEFFROY	G AH D EH F R OW IY
GOESSEL	G OW EH S AH L
GOETZVILLE	G OW EH T S V AH L
GOFFLE	G AA F AH L
GOLDBOND	G OW L D B AA N D
GOLDENDALE	G OW L D EH N D EY L
GOLDENS	G OW L D AH N Z
GOLDINGTON	G OW L D IH NG T AH N
GOLDONNA	G OW L D AA N AH
GOLDSBORO	G OW L D S B AH R OW
GOLDVEIN	G OW L D V EY N
GOLETA	G AA L AH T AH
GOLFVIEW	G AA L F V Y UW
GOLIAD	G OW L IY AH D
GOLOVIN	G AA L AH V AH N
GOLTRY	G OW L T R IY
GOLTS	G OW L T S
GOLVA	G OW L V AH
GONIC	G AO N IH K
GONVICK	G AA N V AH K
GOOCHLAND	G UH K L AH N D
GOODLETTSVILLE	G UW D L EH T S V AH L
GOODNEWS	G UH D N UW Z
GOODSPRING	G UH D S P R IH NG
GOODSPRINGS	G UH D S P R IH NG Z
GOODVIEW	G UH D V Y UW
GOODWATER	G UH D W AO T ER
GOODWELL	G UH D W EH L
GOODWOOD	G UH D W UH D
GOODYEARS	G UH D Y IH ER Z
GORCE	G AO R S
GORDENS	G AO R D AH N Z
GORDO	G AO R D OW
GORDONHURST	G AO R D AA N HH AH R S T
GORDONS	G AO R D AH N Z
GORDONSVILLE	G AO R D AA N S V AH L
GORDONVILLE	G AO R D AA N V AH L
GOREVILLE	G AO R AH V AH L
GORMANIA	G AO R M EY N Y AH
GOSPORT	G OW S P OW R T
GOTEBO	G AA T AH B OW
GOULDBUSK	G OW L D AH S
GOULDSBORO	G OW L D S B AH R OW
GOULDTOWN	G OW L D T OW N
GOUVERNEUR	G AW V AH R N AH R
GOUVERNOUR	G AW V AH R N AH R
GOUVERNUER	G AW V AH R N Y UW AH R
GOWANDA	G OW AE N D AH
GOWRIE	G OW R AY
GRACEHAM	G R EY S HH AE M
GRACEMONT	G R AE S AH M AH N T
GRACETON	G R EY S T AH N
GRACEVILLE	G R AE S AH V AH L
GRADYVILLE	G R AE D AH V AH L
GRAETTINGER	G R IY T AH NG AH R
GRAFORD	G R AE F AH R D
GRAHAMSVILLE	G R AH HH AE M Z AH L
GRAINFIELD	G R EY N F IY L D
GRAISBURY	G R EY Z B EH R IY
GRAMMERCY	G R AE M ER S IY
GRAMPIAN	G R AE M P IY AH N
GRANBURY	G R AE N B Y AH R IY
GRANBY	G R AE N B IY
GRANDFALLS	G R AE N D F AO L Z
GRANDVILLE	G R AE N D AH L
GRANGERLAND	G R AE N JH AH R L AH N D
GRANGEVILLE	G R AE N JH AH V AH L
GRANITEVILLE	G R AH N IH T AH V AH L
GRANN	G R AE N
GRANNATT	G R AE N AH T
GRANTON	G R AE N T AO N
GRANTSBORO	G R AE N T S B AH R OW
GRANTSBURG	G R AE N T S B AH R G
GRANTSVILLE	G R AE N T S V AH L
GRANTVILLE	G R AE N T V AH L
GRANTWOOD	G R AE N T W UH D
GRAPELAND	G R EY P L AE N D
GRAPEVIEW	G R EY P V Y UW
GRAPEVILLE	G R AE P AH V AH L
GRASMERE	G R AE Z M AH R
GRASONVILLE	G R AH S AA N V AH L
GRASSFLAT	G R AE S F L AE T
GRASSMERE	G R AE S M IH ER
GRASSTON	G R AE S T AH N
GRATH	G R AE TH
GRATIOT	G R EY T IY AH T
GRATON	G R AE T AH N
GRAVESEND	G R EY V S EH N D
GRAWN	G R AO N
GRAWTOWN	G R AH T OW N
GRAYBAR	G R EY B AA R
GRAYLAND	G R EY L AE N D
GRAYMONT	G R EY M AH N T
GRAYSVILLE	G R EY Z AH L
GRAYVILLE	G R EY V AH L
GREATE	G R IY EY T
GREENACRE	G R IY N EY K ER
GREENACRES	G R IY N EY K ER Z
GREENBACKVILLE	G R IY N B AE K V AH L
GREENBANK	G R IY N B AE NG K
GREENBRIAR	G R IY N B R AY ER
GREENBRIER	G R IY N B R AY AH R
GREENBROOK	G R IY N B R UH K
GREENBROOKE	G R IY N B R AH K
GREENCREEK	G R IY N K R IY K
GREENCROFT	G R IY N K R AO F T
GREENDALE	G R IY N D EY L
GREENEHAVEN	G R IY N EH HH AH V AH N
GREENHILLS	G R IY N HH IH L Z
GREENLAWN	G R IY N L AO N
GREENLEIGH	G R IY N L EY
GREENMOUNT	G R IY N M AW N T
GREENMOUNTAIN	G R IY N M AW N T AH N
GREENPOINT	G R IY N P OY N T
GREENPORT	G R IY N P OW R T
GREENRALE	G R IY N R EY L
GREENSIDE	G R IY N S AY D
GREENTOP	G R IY N T AA P
GREENTOWN	G R IY N T AW N
GREENTREE	G R IY N T R IY
GREERS	G R IH R Z
GREGLAWN	G R EH G L AH N
GRENELEFE	G R EH N AH L IY F
GRENLOCH	G R EH N L AH CH
GRENOLA	G R EH N AH L AH
GRENVILLE	G R EH N V AH L
GRES	G R Z
GREYBULL	G R EY B UH L
GREYCLIFF	G R EY K L IH F
GREYLOCK	G R EY L AA K
GRIERS	G R IY R Z
GRIFFITHSVILLE	G R IH F IH TH S V AH L
GRIFFITHVILLE	G R IH F IH TH V AH L
GRIFTON	G R IH F T AH N
GRIGGSVILLE	G R IH G S V AH L
GRIMESLAND	G R AY M Z L AE N D
GRIMSBY	G R IH M Z B AY
GRN	JH IY AA R N
GRND	JH IY AA R EH N D
GROSSINGER	G R OW S IH NG ER
GROSVENORD	G R AA Z AH N AH R D
GROTTOES	G R AA T OW Z
GROVELAND	G R OW V L AE N D
GROVEOAK	G R OW V OW K
GROVEPORT	G R OW V P OW R T
GROVERTOWN	G R OW V ER T AW N
GROVESPRING	G R OW V S P R IH NG
GROVETON	G R OW V T AH N
GROVETOWN	G R OW V T AW N
GRUETLI	G R UW EH T L IY
GRULLA	G R AH L AH
GRYGLA	G R IH G L AH
GRYMES	G R AY M Z
GS	JH IY S
GSA	G S AA
GSP	JH IY EH S P
GUADALUPITA	G Y UW AH D AH L UW P AH T AH
GUALALA	G Y UW AE L AH L AH
GUELPH	G Y UW AH L F
GUERLAIN	G Y UW AH R L EY N
GUEYDAN	G Y UW EH AH D AH N
GUILDERLAND	G IH L D ER L AE N D
GUINDA	G UW N D AH
GUINEVERE	G UW N IY V AH R
GUINZBURG	G UW N Z AH R G
GULSTON	G AH L S T AH N
GUNTERSVILLE	G AH N T AH R S V AH L
GUNTON	G AH N T AH N
GUNTOWN	G AH N T AW N
GURDON	G AH R D AH N
GURINO	G Y UH R AH N OW
GUSTINE	G AH S T AY N
GUYAN	G Y UW AY AH N
GUYSVILLE	G Y UW IH Z AH L
GW	JH IY W
GWENN	G W EH N
GWYNEDD	G W IH N AH D
HABRA	HH AE B R AH
HACKETTSTOWN	HH AE K AH T S T OW N
HACKLEBURG	HH AE K L AH B AH R G
HADDAM	HH AE D AH M
HADDIX	HH AE D AH K S
HAFSTROM	HH AE F S T R AH M
HAGARVILLE	HH AH G AA R V AH L
HAGERHILL	HH AE JH AH R AH L
HAHIRA	HH AE HH AH R AH
HAHNVILLE	HH AE N V AH L
HAINESPORT	HH EY N EH S AH R T
HAKALAU	HH AE K AH L AH
HALCOTT	HH AE L K AH T
HALEDON	HH EY L D AA N
HALEIWA	HH EY L IY W AH
HALESITE	HH EY L S AY T
HALETHORPE	HH AE L AH TH AH R P
HALEYVILLE	HH EY L EY V AH L
HALLETTSVILLE	HH AE L EH T S V AH L
HALLISTER	HH AO L IY S T ER
HALLSBORO	HH AE L S B AH R OW
HALLSTEAD	HH AO L S T EH D
HALLSVILLE	HH AE L S V AH L
HALMA	HH AE L M AH
HALMAR	HH AE M AH R
HALSTAD	HH AE L S T AH D
HAMDEN	HH AE M D EH N
HAMERSVILLE	HH AH M AH R S V AH L
HAMLETTE	HH AE M L EH T
HAMMARSKJOLD	HH AE M AH R S JH OW L D
HAMMELS	HH AE M AH L Z
HAMMONDSPORT	HH AE M AA N D S P AH R T
HAMMONDSVILLE	HH AE M AA N D S V AH L
HAMMONTON	HH AE M AA N T AH N
HAMPDEN	HH AE M P D AH N
HAMPTONVILLE	HH AE M P T AA N V AH L
HAMSHIRE	HH AE M SH AY ER
HANAPEPE	HH AE N AH P IY P
HANCEVILLE	HH AE N S AH V AH L
HANDSOM	HH AE N D S AH M
HANIS	HH EY N AH S
HANKAMER	HH AE NG K EY M AH R
HANKSVILLE	HH AE NG K S V AH L
HANLONTOWN	HH AE N L AH N T OW N
HANNACROIX	HH AE N AH K R OY K S
HANNOVER	HH AE N OW V AH R
HANOVERTON	HH AE N AH V AH R T AH N
HANSBORO	HH AE N S B AH R OW
HANSKA	HH AE N S AH
HANSTON	HH AE N S T AH N
HANSVILLE	HH AE N S V AH L
HAPEVILLE	HH AE P AH V AH L
HARBORCREEK	HH AA R B ER K R IY K
HARBORVIEW	HH AA R B ER V Y UW
HARDEEVILLE	HH AA R D IY V AH L
HARDENBURG	HH AA R D EH N B AH R G
HARDENVILLE	HH AA R D EH N V AH L
HARDINGVILLE	HH AA R D IH N G AH L
HARDINSBURG	HH AA R D IH N S B AH R G
HARDSHELL	HH AA R D SH EH L
HARDTNER	HH AA R D T N AH R
HARDYVILLE	HH AA R D AH V AH L
HARGILL	HH AA R JH AH L
HARGOLD	HH AA R G OW L D
HARKERS	HH AA R K ER Z
HARLETON	HH AA R L AH T AH N
HARLEYVILLE	HH AA R L EY V AH L
HARPERSFIELD	HH AA R P ER Z F IY L D
HARPERSVILLE	HH AA R P AH R S V AH L
HARPSWELL	HH AA R P S W EH L
HARPURSVILLE	HH AA R P AH R S V AH L
HARRAHS	HH AE R AH Z
HARRELLS	HH AE R AH L Z
HARRELLSVILLE	HH AE R EH L S V AH L
HARRIETTA	HH AE R IY T AH
HARRISONBURG	HH AE R AH S AA N B AH R G
HARRISONVILLE	HH AE R AH S AA N V AH L
HARRISTOWN	HH AE R IY Z T AW N
HARRISVILLE	HH AE R IH Z AH L
HARROGATE	HH AE R AH G EY T
HARROWS	HH AE R OW Z
HARSENS	HH AA R S AH N Z
HARSIMUS	HH AA R S AH M AH S
HARTINGTON	HH AA R T IH NG T AH N
HARTLY	HH AA R T L IY
HARTSBURG	HH AA R T S B AH R G
HARTSDALE	HH AA R T S D EY L
HARTSELLE	HH AA R T S AH L
HARTSTOWN	HH AA R T S T AW N
HARTVILLE	HH AA R T V AH L
HARVEYS	HH AA R V EY Z
HARVEYVILLE	HH AA R V EY V AH L
HARVIELL	HH AA R V IY L
HARWAY	HH AA R W EY IY
HARWICH	HH AA R W AH CH
HARWINTON	HH AA R W IH N T AH N
HASLACH	HH AE Z L AH CH
HASLET	HH AA Z L AH T
HASSOCK	HH AA Z S AA K
HATBORO	HH AE T B AH R OW
HATCHECHUBBEE	HH AE CH AH CH AH B IY IY
HATTIESBURG	HH AE T IY Z AH R G
HATTIEVILLE	HH AE T IY V AH L
HATTING	HH AE T IH NG
HAUBSTADT	HH AO B S T AH D T
HAUGHWOUT	HH AH W AW T
HAUULA	HH AO UW L AH
HAVEMEYER	HH AH V IY M EY AH R
HAVENSVILLE	HH AH V EH N S V AH L
HAVENWOOD	HH EY V AH N W UH D
HAVERHILL	HH AE V AH R AH L
HAVERMEYER	HH AH V AH R M EY AH R
HAVERSTRAW	HH AH V AH R S T R AH
HAVERTOWN	HH AE V AH R T OW N
HAVILAH	HH AE V AH L AH
HAVRE	HH EY V AH R
HAWARDEN	HH AO AA R D AH N
HAWESVILLE	HH AO EH Z AH L
HAWI	HH AO IY
HAWICK	HH AO AH K
HAWKIN	HH AO K IH N
HAWKINSVILLE	HH AH K IH N S V AH L
HAWKSTONE	HH AO K S T OW N
HAWTREE	HH AO T R IY
HAXTUN	HH AE K S T AH N
HAYDENVILLE	HH EY D EH N V AH L
HAYESVILLE	HH EY EH Z AH L
HAYFORK	HH EY F AO R K
HAYNESVILLE	HH EY N EH Z AH L
HAYNEVILLE	HH EY N AH V AH L
HAYSI	HH EY S IY
HAYSVILLE	HH EY Z AH L
HAYT	HH EY T
HAYTI	HH EY T IY
HAZELGREEN	HH EY Z AH L G R IY N
HAZELHURST	HH AH Z EH L HH AH R S T
HAZELVIEW	HH EY Z AH L V Y UW
HAZLEHURST	HH AE Z L AH HH AH R S T
HAZLET	HH AE Z L AH T
HBLR	EY CH B IY EH L R
HEADLAND	HH EH D L AE N D
HEALDSBURG	HH EH L D S B AH R G
HEALDTON	HH EH L D T AH N
HEARTHSTONE	HH AA R TH S T OW N
HEARTWELL	HH AA R T W EH L
HEATHSVILLE	HH IY TH S V AH L
HEB	HH EH B
HEBBRONVILLE	HH EH B R AA N V AH L
HEBERTON	HH AH B AH R T AH N
HEBO	HH EH B OW
HEGINS	HH EH JH AH N Z
HEGNEY	HH EH G N IY
HEIG	HH EY G
HEILPRIN	HH IY L P R AH N
HEIMDAL	HH IY M D AH L
HEISLERVILLE	HH IY Z L AH R V AH L
HELENDALE	HH EH L AH N D EY L
HELENVILLE	HH AH L EH N V AH L
HELENWOOD	HH EH L AH N W UW D
HELLAM	HH EH L AH M
HELLERTOWN	HH EH L ER T AW N
HELMETTA	HH EH L M EH T AH
HELMVILLE	HH EH L M V AH L
HELTONVILLE	HH EH L T AA N V AH L
HELVETIA	HH EH L V IY SH IY AH
HEMET	HH EH M AH T
HEMINGFORD	HH EH M IH NG F OW R D
HEMPLE	HH EH M P AH L
HENAGAR	HH EH N IH JH ER
HENDERSONVILLE	HH EH N D AH R S AA N V AH L
HENDRUM	HH EH N D R AH M
HENNIKER	HH EH N AY K AH R
HENOCH	HH EH N AH CH
HENRICO	HH EH N R AH K OW
HENRYVILLE	HH EH N R AH V AH L
HEPHZIBAH	HH EH F Z AH B AH
HERCULANEUM	HH AH R K Y AH L EY N IY AH M
HEREFORT	HH EH R AH F AH R T
HERKIMER	HH AH R K AY M AH R
HERMANSVILLE	HH AH R M AE N S V AH L
HERMANTOWN	HH AH R M AH N T OW N
HERMANVILLE	HH AH R M AE N V AH L
HERMANY	HH AH R M AH N IY
HERMISTON	HH AH R M IH S T AH N
HERMLEIGH	HH AH R M L EY
HERNSHAW	HH AH R N SH AH
HERPERS	HH AH R P AH R Z
HERSCHER	HH AH R S AH R
HERZL	HH AH R Z L
HESPERIA	HH EH S IY R IY AH
HESPERUS	HH EH S AH R AH S
HESSMER	HH EH S M AH R
HETFIELD	HH EH T IY L D
HEUSDEN	HH Y UW Z D AH N
HEUVELTON	HH Y UW V EH L T AH N
HEWITTSVILLE	HH Y UW IH T S V AH L
HEYBURN	HH EY B ER N
HEYSON	HH EY S AH N
HEYWORTH	HH EY W ER TH
HGHTS	EY CH JH IY EY CH T IY S
HIALIAH	HH AY AE L AY AH
HIATTVILLE	HH AY AE T V AH L
HIAWASSEE	HH AY AH W AH S IY IY
HICKSTOWN	HH IH K S T AW N
HICO	HH IH K OW
HIDDENITE	HH IH D AH N AY T
HIGGANUM	HH IH G AH N AH M
HIGGINSVILLE	HH IH JH IH N S V AH L
HIGHGATE	HH AY G EY T
HIGHLAN	HH AY L AH N
HIGHLANDVILLE	HH AY L AE N D AH L
HIGHLAWN	HH AY L AO N
HIGHMORE	HH AY M AH R
HIGHMOUNT	HH AY M AW N T
HIGHPOINT	HH AY P OY N T
HIGHPOINTE	HH AY P OY N T
HIGHSPIRE	HH AY S P AY ER
HIGHTOWN	HH AY T AW N
HIGHTSTOWN	HH AY T S T OW N
HIGHVIEW	HH AY V Y UW
HIGHWOOD	HH AY W UH D
HIKO	HH IH K OW
HIL	HH IH L
HILAIRE	HH IH L AH AH R
HILHAM	HH IH L HH AH M
HILLAIRY	HH IH L EH R IY
HILLBROOK	HH IH L B R UH K
HILLBURN	HH IH L B ER N
HILLDALE	HH IH L D EY L
HILLIARDS	HH IH L IY AH R D Z
HILLISBURG	HH IH L IH Z AH R G
HILLISTER	HH IH L IY S T ER
HILLMEYER	HH IH L M EY AH R
HILLPOINT	HH IH L P OY N T
HILLRIDGE	HH IH L R IH JH
HILLROSE	HH IH L R OW Z
HILLSGROVE	HH IH L Z G R OW V
HILLSVILLE	HH IH L S V AH L
HILLTOWN	HH IH L T AW N
HILLVIEW	HH IH L V Y UW
HILLWOOD	HH IH L W UH D
HILMAR	HH IH L M AH R
HILTONIA	HH IH L T OW N Y AH
HIMROD	HH IH M R AH D
HINDSBORO	HH IH N D S B AH R OW
HINDSVILLE	HH IH N D S V AH L
HINESBURG	HH AH N EH Z AH R G
HINESVILLE	HH AH N EH Z AH L
HIRLIMAN	HH AH R L AH M AH N
HITTERDAL	HH IH T AH R D AH L
HIWASSE	HH IH W AH S
HIWASSEE	HH IH W AH S IY IY
HL	EY CH L
HLS	EY CH EH L S
HM	HH AH M
HNDL	EY CH EH N D IY L
HOBBSVILLE	HH AA B S V AH L
HOBE	HH OW B
HOBUCKEN	HH AH B AH K AH N
HOCKESSIN	HH AA K AH S IH N
HOCKHOCKSON	HH AA K HH AA K S AH N
HODA	HH OW D AH
HODE	HH OW D
HODGENVILLE	HH AA JH EH N V AH L
HOESEN	HH OW S EH N
HOGANSBURG	HH AH G AE N S B AH R G
HOGANSVILLE	HH AH G AE N S V AH L
HOGBIN	HH AA G B IH N
HOHOKUS	HH AA HH AH K AH S
HOKAH	HH AA K AH
HOKENDAUQUA	HH AA K AH N D AO K W AH
HOKES	HH OW K S
HOLABIRD	HH AA L AH B AH R D
HOLBERNT	HH OW L B AH R N T
HOLDENVILLE	HH OW L D EH N V AH L
HOLDINGFORD	HH OW L D IH NG F OW R D
HOLDREGE	HH OW L D R IY JH
HOLISTER	HH OW L IY S T ER
HOLLANDALE	HH AA L AH N D EY L
HOLLANSBURG	HH AA L AE N S B AH R G
HOLLIDAYSBURG	HH AA L AH D EY Z AH R G
HOLLINSHED	HH AA L AH N SH T
HOLLOWBROOK	HH AA L OW B R UH K
HOLLSOPPLE	HH AA L S AH P AH L
HOLLYBROOK	HH AA L IH B R AH K
HOLLYBUSH	HH AA L AH B AH SH
HOLLYHILL	HH AA L AH HH AH L
HOLLYTREE	HH AA L AH T R IY IY
HOLMDEL	HH OW L M D AH L
HOLMESVILLE	HH OW L M EH Z AH L
HOLSMAN	HH OW L S M AH N
HOLTSVILLE	HH OW L T S V AH L
HOLTVILLE	HH OW L T V AH L
HOLTWOOD	HH OW L T W UW D
HOLUALOA	HH AA L AH W AE L OW AH
HOLYROOD	HH AA L AH R UW D
HOMECREST	HH OW M K R EH S T
HOMEDALE	HH OW M D EY L
HOMELAWN	HH OW M L AO N
HOMERVILLE	HH AH M AH R V AH L
HOMESTOWN	HH OW M AH S T OW N
HOMEWORTH	HH OW M W ER TH
HONAUNAU	HH AA N AH N AH
HONEOYE	HH OW N IY OY
HONESDALE	HH OW N Z D EY L
HONEYFORD	HH AH N IY F OW R D
HONEYVILLE	HH OW N EY V AH L
HONOBIA	HH AH N OW B IY AH
HONOKAA	HH AA N AH K AH
HONOMU	HH AA N AH M UW
HONORAVILLE	HH AH N AO R AH V AH L
HOODSPORT	HH UH D S P OW R T
HOOKERTON	HH UH K ER T AH N
HOOKSETT	HH UH K S AH T
HOOKSTOWN	HH UH K S T AW N
HOOLEHUA	HH UW L EH HH Y UW AH
HOOPA	HH UW P AH
HOOPESTON	HH UW P AH S T AO N
HOOPLE	HH UW P AH L
HOOSICK	HH UW S AH K
HOOVERSVILLE	HH UW V AH R S V AH L
HOPATCONG	HH AH P AE T AH NG
HOPEDALE	HH OW P D EY L
HOPEMONT	HH AA P AH M AH N T
HOPKINSVILLE	HH AA P IH N S V AH L
HOPLAND	HH AA P L AE N D
HOQUIAM	HH AA K W IY AH M
HORDVILLE	HH AO R D AH L
HOREB	HH AO R AH B
HORICON	HH AO R AH K AH N
HORNERSVILLE	HH AO R N AH R S V AH L
HORNESVILLE	HH AO R N EH Z AH L
HORNITOS	HH AO R N AH T AH Z
HORNTOWN	HH AO R N T AW N
HORSEHEADS	HH AO R S HH EH D Z
HORSENECK	HH AO R S N EH K
HORTENSE	HH AO R T AH N S
HORTONVILLE	HH AO R T AA N V AH L
HOS	HH AA Z
HOSCHTON	HH AA S T AH N
HOSMER	HH AA Z M AH R
HOSP	HH AA S
HOSP.	HH AA S
HOSPERS	HH AA S AH R Z
HOSSTON	HH AA S T AH N
HOTEVILLA	HH AA T AH V IH L AH
HOULKA	HH OW L K AH
HOUMA	HH AW M AH
HOUSATONIC	HH AW S AH T AH N AH K
HOUSTONIA	HH AW S T OW N Y AH
HOUTZDALE	HH AW T S D EY L
HOVENDEN	HH OW V AH N D EH N
HOWARDS	HH OW AH R D Z
HOWARDSTOWN	HH OW AH R D S T OW N
HOWARDSVILLE	HH OW AA R D S V AH L
HOWERTONS	HH AW ER T AH N Z
HOWMEDICA	HH OW M EH D AH K AH
HOYLETON	HH OY AH L T AH N
HOYM	HH OY M
HRADEC	HH R AE D AH K
HS	EY CH S
HUALAPAI	HH Y UW AE L AH P EY
HUBBARDSTON	HH AH B AA R D Z T AH N
HUBBARDSVILLE	HH AH B AA R D S V AH L
HUBBARDTON	HH AH B AA R D T AH N
HUBERTS	HH Y UW B AH R T S
HUBERTUS	HH Y UW B AH R T AH S
HUBLY	HH AH B L IY
HUCKELBERRY	HH AH K EH L B EH R IY
HUDS	HH AH D Z
HUDSONVILLE	HH AH D S AA N V AH L
HUEMMER	HH Y UW EH M AH R
HUENEME	HH Y UW AH N IY M
HUEYTOWN	HH Y UW IY T AW N
HUGER	HH Y UW JH ER
HUGHESVILLE	HH AH EH Z AH L
HULBERTON	HH AH L B AH R T AH N
HUMANSVILLE	HH Y UW M AE N S V AH L
HUMBIRD	HH AH M B ER D
HUMBOLT	HH AH M B OW L T
HUMESTON	HH AH M AH S T AO N
HUMMELSTOWN	HH AH M AH L S T OW N
HUMNOKE	HH AH M N OW K
HUMPTULIPS	HH AH M P T UW L AH P S
HUNLOCK	HH AH N L AH K
HUNTERDON	HH AH N T ER D AA N
HUNTERFLY	HH AH N T ER F L AY
HUNTERSPOINT	HH AH N T ER Z P OY N T
HUNTERTOWN	HH AH N T ER T AW N
HUNTINGBURG	HH AH N T IH N G AH R G
HUNTINGTOWN	HH AH N T IH NG T AW N
HUNTLAND	HH AH N T L AE N D
HUNTSBURG	HH AH N T S B AH R G
HURDEN	HH AH R D AH N
HURDLAND	HH AH R D L AH N D
HURDSFIELD	HH AH R D S F IY L D
HURFF	HH AH R F
HURFVILLE	HH AH R F V AH L
HURLEYS	HH AH R L EY Z
HURLEYVILLE	HH AH R L EY V AH L
HURTSBORO	HH AH R T S B AH R OW
HUSLIA	HH AH Z L IY AH
HUSTONTOWN	HH AH S T AH N T OW N
HUSTONVILLE	HH AH S T AA N V AH L
HUTSONVILLE	HH AH T S AA N V AH L
HUTTIG	HH AH T AH G
HUTTONSVILLE	HH AH T AA N S V AH L
HWY.	W AY
HYATTSVILLE	HH AY AE T S V AH L
HYATTVILLE	HH AY AE T V AH L
HYDABURG	HH IH D AH B AH R G
HYDES	HH AY D Z
HYDESVILLE	HH AH D EH Z AH L
HYLAN	HH AY L AH N
HYRUM	HH IH R AH M
HYSHAM	HH IH SH AH M
HYTOP	HH IH T AH P
IAEGER	AY IY JH AH R
IBERVILLE	AH B AH R V AH L
ICKER	IH K AH R
ICKESBURG	IH K EH Z AH R G
IDABEL	IH D AH B AH L
IDALOU	IH D AH L UW
IDANHA	AH D AE N HH AH
IDAVILLE	IH D AH V AH L
IDER	AY D AH R
IDLEASE	IH D L IY Z
IDLEYLD	IH D L EY L D
IDYLLWILD	AY D AH L W AY L D
IFO	IH F OW
IGIUGIG	IH JH IY UW JH AH G
IGROSS	IH G R AH S
II	IY
III	IY IY
IJAMSVILLE	AH JH AE M Z AH L
ILE	AY L
ILION	IH L Y AH N
ILLIOPOLIS	IH L IY AA P AH L AH S
ILWACO	IH L W AH K OW
ILYSE	AH L AY Z
ILYSSA	AH L IH S AH
IMBLER	IH M B L AH R
IMLAYSTOWN	IH M L EY Z T AW N
IMMOKALEE	IH M AH K AH L IY IY
IMNAHA	IH M N AE HH AH
INAVALE	IH N AH V EY L
INCHELIUM	IH N CH IY L IY AH M
INDALE	IH N D EY L
INDIAHOMA	IH N D AY AE HH AH M AH
INDIALANTIC	IH N D AY AH L AH N T IH K
INDIANTOWN	IH N D AY AH N T OW N
INDORE	IH N D AO R
INGLESIDE	IH N G L AH S AY D
INGOMAR	IH N G OW M AA R
INGRESS	IH N G R EH S
INIGOES	IH N AH G OW Z
INKOM	IH N K AA M
INKSTER	IH NG K S T ER
INOLA	AH N AA L AH
INSLEE	IH N Z L IY
INSPIRA	IH N S IH R AH
INSTITU	IH N S T IH T UW
INTERBOROUGH	IH N T ER B ER OW
INTERLACHEN	IH N T AH R L AE CH AH N
INTERLAKEN	IH N T ER L EY K AH N
INTERLOCHEN	IH N T AH R L AA CH AH N
INTERPACE	IH N T ER P EY S
INTERVALE	IH N T ER V EY L
INTIRE	IH N T AY ER
INTOSH	IH N T AA SH
INTYRE	IH N T AY R
INVER	IH N V AH R
IONIA	AY OW N Y AH
IPAVA	IH P AH V AH
IPSWICH	IH P S W AH CH
IRAAN	IH R EY AH N
IRASBURG	AH R AE Z AH R G
IREDELL	AY ER D EH L
IRMO	AH R M OW
IRONDALE	AY ER N D EY L
IRONTO	AH R AA N T OW
IRRIGON	IH R IH G AO N
IRVINGTON	AH R V IH N G T AH N
IRVONA	AH R V AH N AH
IRWINTON	IH R W IH N T AH N
IRWINVILLE	AH R W IH N V AH L
ISANTI	AH S AE N T IY
ISCHUA	IH S Y UW AH
ISERNIA	AH S AH R N IY AH
ISIDRO	AH S IH D R OW
ISL	IH Z L
ISLAMORADA	IH Z L AH M AO R AH D AH
ISLAN	IH Z L AH N
ISLANDTON	AY L AH N D T AH N
ISLD	IH Z L D
ISLESBORO	IH Z L EH Z AH R OW
ISLETON	AY L T AH N
ISLIN	IH Z L AH N
ISLINGTON	AY L IH NG T AH N
ISMAY	AY Z M EY
ISONVILLE	AH S AA N V AH L
ISORA	IH S AH R AH
ISSAQUAH	IH S AE K W AH
ISZARD	IH Z AH R D
ITTA	IH T AH
IUKA	AY UW K AH
IVEL	IH V AH L
IVESDALE	IH V AH Z D EY L
IVORYTON	AY V AH R IY T AH N
IXONIA	IH K S OW N Y AH
IZORO	IH Z AH R OW
J.F.	JH EY EH F
J.F.K.	JH EY EH F K EY
J.J.	JH EY JH EY
JABEZ	JH AE B AH Z
JACHIN	JH AE CH AH N
JACHNER	JH AE K N AH R
JACKHORN	JH AE K HH AO R N
JACKSBORO	JH AE K S B AH R OW
JACKSONBURG	JH AE K S AA N B AH R G
JACUMBA	JH AH K AH M B AH
JAKIN	JH AE K AH N
JAL	JH AE L
JAMBOREE	JH AE M B AO R IY
JAMESBURG	JH AH M EH Z AH R G
JAMESPORT	JH AH M EH S AH R T
JAMESVILLE	JH AH M EH Z AH L
JAMUL	JH AE M AH L
JARALES	JH AA R EY L Z
JARRETTSVILLE	JH AE R EH T S V AH L
JARVISBURG	JH AA R V IH Z AH R G
JAUNCEY	JH AO N S IY
JAYDEE	JH EY D IY IY
JAYESS	JH EY AH S
JAYTON	JH EY T AH N
JC	JH EY K
JCP	JH EY S IY P
JCT.	JH EY S IY T IY
JEFFERSONTON	JH EH F AH R S AA N T AH N
JEFFERSONTOWN	JH EH F AH R S AH N T OW N
JEFFERSONVILLE	JH EH F AH R S AA N V AH L
JELIFF	JH EH L AH F
JELLICO	JH EH L AH K OW
JELM	JH EH L M
JEMEZ	JH EH M AH Z
JENERA	JH EH N AH R AH
JENKINSBURG	JH EH NG K IH N S B AH R G
JENKINSVILLE	JH EH NG K IH N S V AH L
JENNERS	JH EH N AH R Z
JENNIFERN	JH EH N AH F AH R N
JERICO	JH EH R AH K OW
JEROMESVILLE	JH EH R AH M EH Z AH L
JERRYS	JH EH R IY Z
JERSEYVILLE	JH AH R S EY V AH L
JESSIEVILLE	JH EH S IY V AH L
JETERSVILLE	JH AH T AH R S V AH L
JETMORE	JH EH T M AH R
JF	JH EY F
JFK	JH EY EH F K EY
JIGGS	JH IH G Z
JOBEAN	JH OW B IY AH N
JOBSTOWN	JH AA B Z T AW N
JOELTON	JH OW EH L T AH N
JOFFRE	JH AA F AH R
JOHNSBURG	JH AA N S B AH R G
JOHNSBURY	JH AA N Z B EH R IY
JOHNSONBURG	JH AA N S AA N B AH R G
JOHNSONVILLE	JH AA N S AA N V AH L
JOHNSVILLE	JH AA N S V AH L
JOJO	JH OW JH OW
JOLIETTE	JH AA L AY EH T
JOLINE	JH AH L AY N
JOLO	JH OW L OW
JONESBOROUGH	JH AH N EH Z AH R UW
JONESBURG	JH AH N EH Z AH R G
JONESPORT	JH AH N EH S AH R T
JONESVILLE	JH AH N EH Z AH L
JONQUIL	JH AA N K W AH L
JONY	JH OW N IY
JOPPA	JH AA P AH
JORALEMON	JH AH R AE L AH M AH N
JORDANVILLE	JH AO R D AE N V AH L
JORI	JH AO R IY
JOURDANTON	JH AH R D AE N T AH N
JOURNEAY	JH AH R N IY IY
JOVAL	JH OW V AH L
JR	JH EY R
JR.	JH EY AA R
JUDA	JH UW D AH
JUDES	JH UW D Z
JUDSONIA	JH AH D S OW N Y AH
JUGHANDLE	JH AH G HH AE N D AH L
JULESBURG	JH UW L EH Z AH R G
JULIAETTA	JH UW L IY IY T AH
JULIEANN	JH UW L IY AH N
JULIUSTOWN	JH UW L IY AH S T OW N
JUMEL	JH UW M AH L
JUNALUSKA	JH UW N AH L AH S AH
JUNC	JH AH NG K
JUNCT	JH AH NG K T
JUNCTI	JH AH NG K T IY
JUNCTIO	JH AH NG K T IY OW
JUNI	JH UW N IY
JUNTURA	JH AH N T Y AH R AH
KAAAWA	K AA AH AH
KADOKA	K AE D AH K AH
KAHOKA	K AE HH AH K AH
KAIBITO	K EY B AH T OW
KAIGHN	K EY N
KALAMA	K AE L AH M AH
KALAUPAPA	K AH L AO P AH P AH
KALEVA	K AE L AH V AH
KALI	K AE L IY
KALMIA	K AE L M IY AH
KALONA	K AE L AH N AH
KALSKAG	K AE L S AH G
KALTAG	K AE L T AH G
KALTENMEIER	K AE L T EH N M EY AH R
KALVER	K AE L V AH R
KALVESTA	K AE L V EH S T AH
KAMAS	K AE M AH Z
KAMENA	K AE M AH N AH
KAMIAH	K EY M AY AH
KAMPSVILLE	K AE M P S V AH L
KAMRAR	K AE M R AH R
KAMUELA	K AE M Y UW AH L AH
KANARANZI	K AE N AH R AE N Z IY
KANDIYOHI	K AE N D IY AY AH HH IY
KANEOHE	K EY N IY AH HH
KANNAPOLIS	K AE N AE P AH L AH S
KANOPOLIS	K AH N AA P AH L AH S
KANORADO	K AH N AO R AH D OW
KANSASVILLE	K AE N S AE Z AH L
KAPAA	K AE P AH
KAPAAU	K AE P AH UW
KAPOLEI	K AH P OW L IY
KAPPOCK	K AE P AH K
KARBERS	K AA R B AH R Z
KARLSTAD	K AA R L S T AH D
KARNACK	K AA R N AH K
KARNAK	K AA R N AH K
KARTHAUS	K AA R TH EY AH S
KARVAL	K AA R V AH L
KARWEG	K AA R W AH G
KASILOF	K AE S AH L AH F
KASOTA	K AE S AH T AH
KATAN	K EY T AH N
KATONAH	K AE T AH N AH
KATRINE	K AE T R AY N
KAUKAUNA	K AO K AH N AH
KAUMAKANI	K AH M AE K AH N IY
KAVETT	K AE V AH T
KAVRIK	K AE V R AH K
KAW	K AO
KAWKAWLIN	K AO K AH L AH N
KAYCEE	K EY S IY IY
KAYENTA	K EY EH N T AH
KAYSVILLE	K EY Z AH L
KAZIMIROFF	K AH Z IH M AH R AH F
KEAAU	K IY AH
KEALAKEKUA	K IY L AH K EH K Y UW AH
KEAMS	K IY M Z
KEANSBURG	K IY N S B AH R G
KEAP	K IY P
KEARNEYSVILLE	K AH R N EY Z AH L
KEARSAGE	K AH R S AH JH
KEASBEY	K IY Z IY
KEATCHIE	K IY CH AY
KEAVY	K IY V IY
KEEDYSVILLE	K IY D IH Z AH L
KEEGANS	K IY G AH N Z
KEELINE	K IY L AY N
KEENES	K IY N Z
KEENESBURG	K IY N EH Z AH R G
KEER	K IY AH R
KEESEVILLE	K IY S AH V AH L
KEESPORT	K IY S AH R T
KEEZLETOWN	K IY Z L AH T OW N
KEIBER	K IY B AH R
KEITHSBURG	K IY TH S B AH R G
KEITHVILLE	K IY TH V AH L
KEKAHA	K EH K AH HH AH
KELDRON	K EH L D R AH N
KELFORD	K EH L F AH R D
KELLERTON	K EH L AH R T AH N
KELLERVILLE	K EH L AH R V AH L
KELLEYS	K EH L EY Z
KELLNERSVILLE	K EH L N AH R S V AH L
KELLYTON	K EH L AH T AH N
KELLYVILLE	K EH L AH V AH L
KELSEYVILLE	K EH L S EY V AH L
KELTYS	K EH L T AH Z
KEMBALL	K EH M B AH L
KENANSVILLE	K AH N AE N S V AH L
KENBRIDGE	K EH N B R IH JH
KENDALIA	K EH N D EY L Y AH
KENDALLVILLE	K EH N D AE L V AH L
KENDUSKEAG	K EH N D AH S IY G
KENEDY	K EH N D IY
KENEFIC	K EH N AH F AH K
KENESAW	K EH N AH S AH
KENLY	K EH N L IY
KENNEBEC	K EH N AH B AH K
KENNEBUNK	K EH N AH B AH NG K
KENNEDALE	K EH N D EY L
KENNEDYVILLE	K EH N EH D AH V AH L
KENNELLWORTH	K EH N EH L W AH R TH
KENNELWORTH	K EH N AH L W ER TH
KENNERDELL	K EH N ER D EH L
KENNEWICK	K EH N Y UW AH K
KENOVA	K EH N OW V AH
KENOZA	K EH N AH Z AH
KENSAL	K EH N Z AH L
KENSETT	K EH N S AH T
KENSICO	K EH N S AH K OW
KENTFIELD	K EH N T IY L D
KENTLAND	K EH N T L AH N D
KENTS	K EH N T S
KENTUCK	K EH N T AH K
KENTWOOD	K EH N T W UW D
KENVIL	K EH N V AH L
KENVIR	K EH N V AH R
KEOKEE	K IY AH K IY IY
KEOSAUQUA	K IY AH S AO K W AH
KEOTA	K IY AH T AH
KERENS	K EH R AH N Z
KERHONKSON	K AH R AO NG K S AH N
KERKHOVEN	K AH R K AH V AH N
KERNERSVILLE	K AH R N AH R S V AH L
KERNVILLE	K AH R N V AH L
KERO	K EH R OW
KESHENA	K EH SH AH N AH
KESLERS	K EH Z L AH R Z
KESLEY	K EH Z L IY
KETAL	K IY T AH L
KETTLEMAN	K EH T AH L M AE N
KEUTERVILLE	K Y UW T AH R V AH L
KEVIL	K EH V AH L
KEWADIN	K Y UW AH D AH N
KEWANEE	K Y UW AH N IY IY
KEWANNA	K Y UW AE N AH
KEWASKUM	K Y UW AE S AH M
KEWEENAW	K Y UW IY N AH
KEYAPAHA	K EY AE P AH HH AH
KEYESPORT	K EY EH S AH R T
KEYMAR	K IY M AA R
KEYPORT	K IY P OW R T
KEYSVILLE	K EY Z AH L
KEYTESVILLE	K EY T EH Z AH L
KEZAR	K IY Z AH R
KIAMESHA	K AY AE M AH SH AH
KIANA	K AY AH N AH
KIBBIN	K IH B AH N
KIHEI	K IH HH IY
KILBUCK	K IH L B AH K
KILDARE	K IH L D AH R
KILKENNY	K IH L K EH N IY
KILLARNEY	K IH L AA R N IY
KILLBUCK	K IH L B AH K
KILLDEER	K IH L D IH ER
KILLINGLY	K IH L IH NG L IY
KILLINGWORTH	K IH L IH NG W ER TH
KILMICHAEL	K IH L M AH CH IY L
KILROE	K IH L R OW
KILSYTH	K IH L S AH TH
KIMBALLTON	K IH M B AE L T AH N
KIMPER	K IH M P AH R
KINARDS	K IH N AH R D Z
KINDE	K IH N D
KINDERHOOK	K AY N D ER HH UH K
KINDERKAMACK	K IH N D AH R K AH M AH K
KINGFIELD	K IH NG F IY L D
KINGSBURG	K IH N G S B AH R G
KINGSDOWN	K IH NG Z D AW N
KINGSTOWN	K IH NG Z T AW N
KINGSTREE	K IH NG Z T R IY
KINGSWICK	K IH NG Z W IH K
KINGWOOD	K IH NG W UH D
KINKORA	K IH NG K AH R AH
KINLEYVILLE	K IH N L EY V AH L
KINMUNDY	K IH N M AH N D IY
KINNELON	K IH N AH L AH N
KINNON	K IH N AH N
KINROSS	K IH N R AH S
KINSALE	K IH N S EY L
KINTA	K IH N T AH
KINTNERSVILLE	K IH N T N AH R S V AH L
KINTYRE	K IH N T AY R
KINZERS	K IH N Z AH R Z
KINZUA	K IH N Z UW W AH
KIOWA	K AY OW AH
KIPNUK	K IH P N AH K
KIRBYVILLE	K AH R B AH V AH L
KIRKSVILLE	K AH R K S V AH L
KIRKVILLE	K AH R K V AH L
KIRON	K IH R AH N
KIRSHON	K AH R SH AH N
KISSENA	K IH S AH N AH
KISWICK	K IH S W AH K
KITTANNING	K IH T AE N IH NG
KITTERY	K IH T AH R IY
KITTRICK	K IH T R IH K
KIVALINA	K AH V AE L AH N AH
KLAMATH	K L AE M AH TH
KLAWOCK	K L AO AH K
KLEECK	K L IY K
KLEUPFEL	K L UW P AH L
KLICKITAT	K L IH K AH T AH T
KLINGERSTOWN	K L IH N JH AH R S T OW N
KLOCKNER	K L AA K N AH R
KLOTEN	K L OW T AH N
KNAUTH	N AO TH
KNESEL	N EH S AH L
KNIFLEY	N IH F L IY
KNIGHTDALE	N AY T D EY L
KNIGHTSEN	N AY T S EH N
KNIGHTSTOWN	N AY T S T AW N
KNOLLS	N OW L Z
KNOLLWOOD	N OW L W UH D
KNOPFE	N AA P
KOBUK	K AA B AH K
KOELTZTOWN	K OW AH L T S T OW N
KOKHANOK	K AA K AH N AH K
KOLIGANEK	K AH L IH G AH N AH K
KOLO	K OW L OW
KOLOA	K AA L OW AH
KONAWA	K AA N AH AH
KOPPERL	K AA P AH R L
KORTRIGHT	K AO R T R AY T
KOSCIUSKO	K AA S IY AH S OW
KOSCIUSZKO	K AA S IY AH Z K OW
KOSHKONONG	K AA SH AH N AH NG
KOSSE	K AA S
KOTLIK	K AA T L AH K
KOUNTZE	K AW N T S
KOUTS	K OW Y UW T S
KOUWENHOVEN	K AW W EH N HH AH V AH N
KOWNVILLE	K OW N V AH L
KOYUK	K OY AH K
KRANZBURG	K R AE N Z AH R G
KREMMLING	K R EH M L AH NG
KREOLE	K R IY OW L
KRESGEVILLE	K R EH Z AH V AH L
KRESSON	K R EH S AH N
KRISSA	K R IH S AH
KRISTAL	K R IH S T AH L
KROTIK	K R AA T AH K
KRUIF	K R UW F
KRUMVILLE	K R AH M V AH L
KRUSER	K R UW Z AH R
KUALAPUU	K Y UW AH L AE P Y UW AH
KULLER	K AH L AH R
KULM	K AH L M
KULPMONT	K AH L P M AH N T
KUNKLETOWN	K AH NG K L AH T OW N
KURE	K Y UH R
KURTISTOWN	K AH R T AH S T OW N
KUSER	K Y UW Z AH R
KUTTAWA	K AH T AH AH
KUTZTOWN	K AH T S T OW N
KWETHLUK	K W EH TH L AH K
KWIGILLINGOK	K W IH JH AH L IH N G AH K
KYANA	K AY AH N AH
KYBURZ	K IH B AH R Z
KYKOTSMOVI	K AH K AA T S M AH V IY
KYROCK	K IH R AH K
L.I.J.MEDICAL	EH L AY JH EY M EH D IH K AH L
LAAGER	L EY AH JH AH R
LABADIEVILLE	L AE B AH D IY V AH L
LABAU	L AE B AH
LABOLT	L AH B OW L T
LABURNUM	L AH B AH R N AH M
LACAMP	L AE K AH M P
LACARNE	L AE K AH R N
LACASSINE	L AE K AH S AY N
LACEYS	L EY S IY Z
LACEYVILLE	L EY S EY V AH L
LACHINE	L AH CH AY N
LACKAWAXEN	L AE K AH W AE K S AH N
LACON	L AE K AH N
LACONA	L AE K AH N AH
LACONIA	L AH K OW N Y AH
LACS	L AE K S
LADDONIA	L AE D OW N Y AH
LADERA	L AE D IH R AH
LADOGA	L AE D AH G AH
LADONIA	L AH D OW N Y AH
LADORA	L AE D AH R AH
LADYSMITH	L EY D IY S M IH TH
LAFE	L EY F
LAGRANGEVILLE	L AE G R AE N JH AH V AH L
LAGRO	L AE G R OW
LAGUNITAS	L AE G Y UW N AH T AH Z
LAHAINA	L AH HH EY N AH
LAHMANSVILLE	L AH M AE N S V AH L
LAHOMA	L AE HH AH M AH
LAIE	L EY
LAIGHT	L EY T
LAINGSBURG	L EY N G S B AH R G
LAIRDSVILLE	L AE AH R D S V AH L
LAJOYA	L AE JH OY AH
LAKEHEAD	L EY K HH EH D
LAKEHILLS	L EY K HH IH L Z
LAKEHURST	L AE K AH HH AH R S T
LAKEMONT	L AE K AH M AH N T
LAKEPORT	L EY K P OW R T
LAKERIDGE	L EY K R IH JH
LAKETOWN	L EY K T AW N
LAKEVILLE	L AE K AH V AH L
LAKEWAY	L EY K W EY
LAMBERTS	L AE M B ER T S
LAMBERTVILLE	L AE M B AH R T V AH L
LAMBRIC	L AE M B R AH K
LAMBSBURG	L AE M B S B AH R G
LAMERO	L AE M AH R OW
LAMESA	L AA M EY S AH
LAMOKA	L AE M AH K AH
LAMONI	L AE M AH N IY
LAMPASAS	L AE M P AH S AH Z
LAMPED	L AE M P T
LANARK	L AE N AH R K
LANCEY	L AE N S IY
LANDENBERG	L AE N D AH N B ER G
LANDISBURG	L AE N D IH Z AH R G
LANDISVILLE	L AE N D IH Z AH L
LANDIX	L AE N D AH K S
LANESBORO	L AH N EH Z AH R OW
LANESVILLE	L AH N EH Z AH L
LANETT	L AE N AH T
LANEVIEW	L EY N V Y UW
LANEVILLE	L AE N AH V AH L
LANEXA	L AH N EH K S AH
LANGERE	L AE N JH AH R
LANKIN	L AE NG K IH N
LANNIGAN	L AE N AH G AH N
LANOKA	L AE N AH K AH
LANSE	L AE N S
LAONA	L EY AH N AH
LAOTTO	L EY AA T OW
LAPEER	L AE P IH R
LAPWAI	L AE P W EY
LAQUEY	L AE K W IY
LARCHWOOD	L AA R K W UW D
LAREINE	L AH R IY N
LARKSLANE	L AA R K S L EY N
LARSENS	L AA R S AH N Z
LARSLAN	L AA R S L AH N
LARTO	L AA R T OW
LARWILL	L AA R W AH L
LASCASSAS	L AE S AE S AH Z
LASHMEET	L AE SH M IY T
LATAH	L AE T AH
LATHRUP	L AE TH R AH P
LATKEN	L AE T AH N
LATTING	L AE T AH NG
LAUGHLINTOWN	L AE F L IH N T OW N
LAUPAHOEHOE	L AO P AH HH OW AH HH OW
LAURELTON	L AO R AH L T AH N
LAURELVILLE	L AH R EH L V AH L
LAURINBURG	L AH R IH N B AH R G
LAURITA	L AO R AH T AH
LAURIUM	L AO R IY AH M
LAVACA	L AE V AH K AH
LAVALETTE	L AE V AH L EH T
LAVALL	L AE V AH L
LAVALLETTE	L AE V AH L EH T
LAVEEN	L EY V IY AH N
LAVONIA	L AH V OW N Y AH
LAWEN	L AO AH N
LAWLINS	L AO L AH N Z
LAWNDALE	L AO N D EY L
LAWNSIDE	L AO N S AY D
LAWSONVILLE	L AH S AA N V AH L
LAWTEY	L AO T IY
LAWTONS	L AO T AH N Z
LAWYERSVILLE	L AO AY AH R S V AH L
LAYTHAM	L EY TH AH M
LAYTONSVILLE	L EY T AA N S V AH L
LAYTONVILLE	L EY T AA N V AH L
LEABURG	L IY B AH R G
LEACHVILLE	L IY CH V AH L
LEADAY	L IY D EY IY
LEADORE	L IY D OW R
LEADWOOD	L IY D W UH D
LEAKESVILLE	L IY K EH Z AH L
LEANSBORO	L IY N S B AH R OW
LEANSVILLE	L IY N S V AH L
LEASBURG	L IY Z AH R G
LEAVITTSBURG	L IY V IH T S B AH R G
LEAWOOD	L IY W UW D
LECATO	L EH K AH T OW
LECOMPTON	L AH K AA M P T AH N
LEDGEWOOD	L EH JH W UH D
LEECHBURG	L IY CH B AH R G
LEEDEY	L IY D IY
LEELANAU	L IY L AH N AH
LEESPORT	L IY S P OW R T
LEESVILLE	L IY Z AH L
LEETON	L IY T AH N
LEETONIA	L IY T OW N Y AH
LEETSDALE	L IY T S D EY L
LEEWOOD	L IY W UH D
LEFOR	L IY F AH R
LEHI	L EH HH IY
LEIPSIC	L IY P S AH K
LEIVASY	L IY V AH Z IY
LEJUNIOR	L AH JH UW N AY AH R
LEMBECK	L EH M B AH K
LEMITAR	L EH M AH T AH R
LEMONCOVE	L EH M AH N K OW V
LEMONDROP	L EH M AH N D R AA P
LEMOORE	L EH M AH R
LEMOYNE	L AH M OY N
LEMPSTER	L EH M P S T AH R
LENAPAH	L EH N AH P AH
LENAPE	L AH N EY P
LENEVAR	L EH N AH V AH R
LENFELL	L EH N F AH L
LENGBY	L EH N G IY
LENHARTSVILLE	L EH N HH AA R T S V AH L
LENOIR	L AH N OY R
LENORAH	L EH N AH R AH
LENOXVILLE	L AH N AA K S V AH L
LENZBURG	L EH N Z AH R G
LENZIE	L EH N Z AY
LEOD	L IY AH D
LEONARDTOWN	L IY AA N AH R D T OW N
LEONARDVILLE	L IY AH N AA R D AH L
LEONELLO	L IY AH N EH L OW
LEONIA	L IY OW N Y AH
LEONIDAS	L IY AO N IY D AH Z
LEOPOLIS	L IY AA P AH L AH S
LEOTI	L IY AH T IY
LEPANTO	L AH P AE N T OW
LERER	L IY R AH R
LERNA	L AH R N AH
LERONA	L EH R AH N AH
LESHARA	L EH SH AH R AH
LESTERVILLE	L EH S T AH R V AH L
LETART	L EH T AA R T
LETOHATCHEE	L EH T AH HH AH CH IY IY
LETTSWORTH	L EH T S W AH R TH
LEUPP	L UW P
LEVELLAND	L EH V AH L AE N D
LEVELOCK	L EH V AH L AH K
LEWES	L UW Z
LEWISBERRY	L UW AH S B EH R IY
LEWISPORT	L UW AH S P OW R T
LEWISTOWN	L UW AH S T AW N
LEWISVILLE	L UW IH Z AH L
LEWMAY	L UW M EY IY
LEXA	L EH K S AH
LGA	L G AA
LIBERTYVILLE	L AH B AH R T AH V AH L
LIBORY	L AY B AH R IY
LICKINGVILLE	L IH K IH N G AH L
LIDDERDALE	L IH D ER D EY L
LIEBENTHAL	L AY B IY AH N TH AH L
LIGNUM	L IH G N AH M
LIGONIER	L AH G AA N AY AH R
LIJ	L IH JH
LILBOURN	L IH L B OW R N
LILBURN	L IH L B AH R N
LILESVILLE	L AH L EH Z AH L
LILLINGTON	L IH L IH N G T AH N
LILLIWAUP	L IH L AH W AH P
LIMINGTON	L AY M IH NG T AH N
LINCOLNTON	L IH NG K OW L N T AH N
LINCOLNVILLE	L IH NG K OW L N V AH L
LINCOLNWOOD	L IH NG K OW L N W UW D
LINCROFT	L IH NG K R AH F T
LINDALE	L IH N D EY L
LINDENHURST	L IH N D EH N HH AH R S T
LINDENWALD	L IH N D EH N W AH L D
LINDENWOLD	L IH N D AH N W OW L D
LINDENWOOD	L IH N D AH N W UH D
LINDRITH	L IH N D R AH TH
LINDSBORG	L IH N D S B AH R G
LINDSEYVILLE	L IH N D S EY V AH L
LINDSIDE	L IH N D S AY D
LINEBORO	L AH N EH B AH R OW
LINEFORK	L AY N F AO R K
LINEVILLE	L IH N AH V AH L
LINKWOOD	L IH NG K W UH D
LINNEAUS	L IH N IY AH S
LINNEUS	L IH N IY AH S
LIPAN	L AY P AH N
LIPINCOTT	L AH P IH NG K AH T
LIPSENARD	L IH P S AH N AH R D
LIRR	L AH R
LISCOMB	L IH S AH M
LISMORE	L IH Z M AH R
LISPENARD	L IH S AH N AH R D
LISTONBURG	L IH S T AA N B AH R G
LITCHVILLE	L IH CH V AH L
LITHIA	L IH TH IY AH
LITHONIA	L AH TH OW N Y AH
LITTCARR	L IH T AH R
LITTLEFORK	L IH T AH L F AO R K
LITTLERIVER	L IH T AH L ER IH V ER
LITTLESTOWN	L IH T AH L AH S T OW N
LIZELLA	L AH Z EH L AH
LIZEMORES	L IH Z AH M AH R Z
LIZTON	L IH Z T AH N
LK	EH L K
LL	EH L
LN.	EH L EH N
LNDG	EH L EH N D IY G
LOAMI	L OW M IY
LOBATA	L AA B AH T AH
LOBELVILLE	L AH B EH L V AH L
LOCHBUI	L AA CH B UW
LOCKBOURNE	L AA K B OW R N
LOCKEFORD	L AA K AH F AH R D
LOCKESBURG	L AA K EH Z AH R G
LOCKLAND	L AA K L AE N D
LOCUSTVILLE	L AH K AH S T V AH L
LODA	L OW D AH
LODOVICK	L AA D AH V AH K
LOEHMANNS	L OW AH M AH N Z
LOGANSPORT	L AH G AE N S AH R T
LOGANTON	L AA G AE N T AO N
LOGANVILLE	L AH G AE N V AH L
LOGSDEN	L AA G Z D EH N
LOHRVILLE	L AA R V AH L
LOHSEN	L AA Z AH N
LOLO	L OW L OW
LOMBARDY	L AA M B AA R D IY
LOMETA	L AA M AH T AH
LOMOND	L AA M AH N D
LONACONING	L AA N AH K OW N AH NG
LONDONDERR	L AA N D AA N D AH R
LONEDELL	L OW N D EH L
LONEPINE	L OW N P AY N
LONGBRANCH	L AO NG B R AE N CH
LONGDALE	L AO NG D EY L
LONGFORD	L AO NG F OW R D
LONGISLAND	L AO NG AY L AH N D
LONGLAKE	L AO NG L EY K
LONGMEADOW	L AO NG M EH D OW
LONGPORT	L AO NG P OW R T
LONGVILLE	L AA N G AH L
LONOKE	L AH N OW K
LOOGOOTEE	L UW G AH T IY IY
LOOKEBA	L UH K AH B AH
LOONEYVILLE	L UW N EY V AH L
LORAMIE	L AH R EY M AY
LORANE	L AH R EY N
LOREAUVILLE	L AO R IY UW V AH L
LORIDA	L AO R AH D AH
LORRETTA	L AO R EH T AH
LOSANTVILLE	L AH S AE N T V AH L
LOSTANT	L AO S T AH N T
LOSTINE	L OW Z T AY N
LOTAWANA	L AH T AO AH N AH
LOTTSBURG	L AA T S B AH R G
LOUANN	L AW AH N
LOUBET	L AW B AH T
LOUDONVILLE	L AW D AA N V AH L
LOUELLEN	L AW EH L AH N
LOUIN	L AW AH N
LOUISBURG	L AW IH Z AH R G
LOUSONS	L AW S AH N Z
LOVELADY	L AH V L EY D IY
LOVELOCK	L AH V L AA K
LOVETTSVILLE	L AH V EH T S V AH L
LOVEVILLE	L AA V AH V AH L
LOVILIA	L AH V IH L Y AH
LOVINGHAM	L AH V IH NG HH AE M
LOVINGSTON	L AH V IH NG Z T AH N
LOVINGTON	L AH V IH NG T AH N
LOWELLVILLE	L OW EH L V AH L
LOWERRE	L OW AH R
LOWESVILLE	L OW EH Z AH L
LOWGAP	L OW G AE P
LOWNDESVILLE	L OW N D EH Z AH L
LOXAHATCHEE	L AA K S AH HH AH CH IY IY
LOXLEY	L AA K S L IY
LOYALHANNA	L OY AH L HH AE N AH
LOYSBURG	L OY Z B AH R G
LOYSVILLE	L OY Z V AH L
LT.	EH L T IY
LUBEC	L UW B AH K
LUCAMA	L UW K AH M AH
LUCAN	L UW K AH N
LUCERNEMINES	L UW S AH R N AH M AY N Z
LUDDINGTON	L AH D IH N G T AH N
LUDELL	L UW D AH L
LUDOWICI	L UW D OW AH S IY
LUEBBERING	L UW AH B IY R AH NG
LUGOFF	L AH G AO F
LUKACHUKAI	L UW K AH CH UW K EY
LULING	L UW L AH NG
LUMBERPORT	L AH M B ER P OW R T
LUMBERVILLE	L AH M B AH R V AH L
LUMMI	L AH M IY
LUNAS	L UW N AH Z
LUNDI	L AH N D IY
LUNDYS	L AH N D AH Z
LUNENBURG	L UW N EH N B AH R G
LUNING	L UW N AH NG
LUQUER	L AH K AH R
LURAY	L UH R EY IY
LURGAN	L AH R G AH N
LURTING	L AH R T AH NG
LUTCHER	L AH CH AH R
LUTHERSBURG	L AH TH AH R S B AH R G
LUTHERSVILLE	L AH TH AH R S V AH L
LUTHERVILLE	L AH TH AH R V AH L
LUTSEN	L AH T S AH N
LUTTS	L AH T S
LUVERNE	L UW V AH R N
LUXEMBURG	L AH K S EH M B AH R G
LUXORA	L AH K S AH R AH
LUZERNE	L UW Z AH R N
LYCEUM	L IH S IY AH M
LYDECKER	L AH D EH K AH R
LYDIG	L IH D AH G
LYNBROOK	L IH N B R AH K
LYNCREST	L IH NG K R AH S T
LYNDALE	L IH N D EY L
LYNDEBOROUGH	L IH N D EH B AH R UW
LYNDONVILLE	L IH N D AA N V AH L
LYNDORA	L IH N D AH R AH
LYNHURST	L IH N HH AH R S T
LYNMAR	L IH N M AH R
LYNNFIELD	L IH N F IY L D
LYNNHAVEN	L IH N HH AH V AH N
LYNNVILLE	L IH N V AH L
LYNNWOOD	L IH N W UW D
LYNWOOD	L IH N W UW D
LYSITE	L AH S AY T
LYVERE	L IH V AH R
MABLETON	M AE B L AH T AH N
MABTON	M AE B T AH N
MACCLENNY	M AE K L EH N IY
MACDOEL	M AE K D OW AH L
MACEDON	M AE K T AO N
MACENZIE	M AH S EH N Z AY
MACEO	M EY S IY OW
MACERO	M AE S AH R OW
MACFARLAN	M AE K AA R L AH N
MACHIAS	M AE CH IY AH Z
MACHIASPORT	M AE CH IY AE S AH R T
MACHIPONGO	M AE CH AH P AA N G OW
MACHPELAH	M AE CH AH L AH
MACKINAC	M AE K AH N AH K
MACKSBURG	M AE K S B AH R G
MACKSVILLE	M AE K S V AH L
MACKVILLE	M AE K V AH L
MACNISH	M AE K N AH SH
MACOMBS	M AE K AH M Z
MACORMAC	M AH K AO R M AH K
MACUNGIE	M AH K AH N JH AY
MADAWASKA	M AE D AH AE S AH
MADBURY	M AE D B EH R IY
MADELIA	M AH D IY L Y AH
MADISONBURG	M AE D AH S AA N B AH R G
MADISONVILLE	M AE D AH S AA N V AH L
MADOR	M AE D ER
MAEYSTOWN	M IY AH S T OW N
MAGALIA	M AH G EY L Y AH
MAHANOY	M AH HH AE N OW IY
MAHASKA	M AH HH AE S AH
MAHNOMEN	M AE N AH M AH N
MAHOMET	M AE HH AH M AH T
MAHOPAC	M AE HH AH P AH K
MAHTO	M AE T OW
MAHTOWA	M AE T OW AH
MAIDSVILLE	M EY D S V AH L
MAINBRIDGE	M EY N B R IH JH
MAINESBURG	M EY N EH Z AH R G
MAINEVILLE	M EY N AH V AH L
MAIZY	M EY AY Z IY
MAKANDA	M AH K AE N D AH
MAKAWAO	M AH K AO EY OW
MAKAWELI	M AH K AO AH L IY
MAKOTI	M AE K AH T IY
MALAD	M AH L AE D
MALAKOFF	M AH L AE K AH F
MALAPARDIS	M AH L AH P AA R D AH S
MALBA	M AE L B AA
MALBONE	M AE L B OW N
MALINTA	M AE L AH N T AA
MALJAMAR	M AE L JH AE M ER
MALMO	M AE L M OW
MALONETON	M AH L AA N AH T AH N
MALVERNE	M AE L V AH R N
MALVINE	M AE L V AY N
MAMOU	M AE M UW
MANAHAWKIN	M AA N AH HH AO K IH N
MANAKIN	M AA N AH K IH N
MANALAPAN	M EY N AH L AH P AE N
MANASQUAN	M AH N AE S W AH N
MANAWA	M AE N AH AH
MANCELONA	M AE N S EH L AH N AH
MANCHACA	M AE NG K AH K AH
MANCOS	M AE NG K AH Z
MANDAN	M AE N D AH N
MANDAREE	M AE N D EH R IY
MANEE	M EY N IY
MANIDA	M AE N AH D AH
MANITO	M AE N AH T OW
MANITOU	M AE N AH T UW
MANITOWISH	M AH N IH T OW AH SH
MANLIUS	M AE N L AY AH S
MANNFORD	M AE N F AH R D
MANNINGTON	M AE N IH NG T AH N
MANNSVILLE	M AE N S V AH L
MANOKOTAK	M AH N AA K AH T AH K
MANORVILLE	M AH N AO R V AH L
MANQUIN	M AE NG K W AH N
MANSE	M AE N S
MANSET	M AE N S EH T
MANSURA	M AE N S AH R AH
MANTACHIE	M AE N T AH CH AY
MANTADOR	M AE N T AH D AH R
MANTEE	M AE N T IY
MANTENO	M AE N T AH N OW
MANTEO	M AE N T IY OW
MANTI	M AE N T IY
MANTOLOKING	M AE N T AH L OW K AH NG
MANTORVILLE	M AE N T AO R V AH L
MANZANOLA	M AE N Z AE N AH L AH
MAPLECREST	M EY P AH L K R EH S T
MAPLESVILLE	M AE P L EH Z AH L
MAPLETON	M EY P AH L T AH N
MAPLETREE	M EY P AH L T R IY
MAPPSVILLE	M AE P S V AH L
MAQUOKETA	M AE K W AA K AH T AH
MAQUON	M AE K W AH N
MARAMEC	M AE R AH M AH K
MARANA	M AE R AH N AH
MARB	M AA R B
MARBLETON	M AA R B AH L T AH N
MARCELINE	M AA R S AH L AY N
MARCOLA	M AA R K AH L AH
MARDELA	M AA R D AH L AH
MARENGO	M EH R AH N G OW
MARENISCO	M AE R AH N IH S OW
MARETZEK	M AH R EH T S AH K
MARFRANCE	M AA R F R AH N S
MARGARETTA	M AA R G AH R EH T AH
MARGARETTSVILLE	M AA R G AH R EH T S V AH L
MARGATE	M AA R G EY T
MARIBA	M AE R AH B AH
MARIENVILLE	M AH R IY N V AH L
MARIES	M EH R IY Z
MARINETTE	M AH R IY N EH T
MARIONVILLE	M AE R IY AA N V AH L
MARKESAN	M AA R K S AH N
MARKETFIELD	M AA R K AH T F IY L D
MARKLETON	M AA R K L EH T AO N
MARKLEVILLE	M AA R K L AH V AH L
MARKLEYSBURG	M AA R K L EY Z AH R G
MARKSVILLE	M AA R K S V AH L
MARKVILLE	M AA R K V AH L
MARLKRESS	M AA R L K R AH S
MARMARTH	M AA R M AA R TH
MARMET	M AA R M EH T
MARMORA	M AA R M AH R AH
MARNE	M AA R N
MAROA	M AE R OW AH
MAROLLA	M AH R AA L AH
MARRIOTTSVILLE	M AE R IY AA T S V AH L
MARSCHER	M AA R S AH R
MARSELLUS	M AA R S EH L AH S
MARSHALLBERG	M AA R SH AO L B ER G
MARSHALLTON	M AA R SH AO L T AH N
MARSHALLVILLE	M AA R SH AE L V AH L
MARSHVILLE	M AA R SH V AH L
MARSING	M AA R Z IH NG
MARSTONS	M AA R Z T AH N Z
MARTENSE	M AA R T EH N S
MARTHAVILLE	M AA R TH AH V AH L
MARTINSBURG	M AA R T IH N S B AH R G
MARTINSDALE	M AA R T AH N Z D EY L
MARTINTON	M AA R T AH N T AH N
MARTINVILL	M AA R T IH N V AH L
MARTLING	M AA R T L IH NG
MARTLINGS	M AA R T L IH NG Z
MARTVILLE	M AA R T V AH L
MARYDEL	M AE R AH D AH L
MARYNEAL	M AH R IH N IY AH L
MARYS	M EH R IY Z
MARYSVALE	M EH R IY Z V EY L
MASCOUTAH	M AE S AW T AH
MASHPEE	M AE SH P IY
MASKLEE	M AE S K L IY
MASONVILLE	M AH S AA N V AH L
MASPETH	M AE S AH TH
MASSAPEQUA	M AE S AH P EH K W AH
MASSENA	M AE S AH N AH
MASSILLON	M AE S IH L AO N
MASTIC	M AE S T IH K
MASURY	M AA Z Y ER IY
MATAMORAS	M AH T AE M AH R AH Z
MATAWAN	M AE T AH W AA N
MATFIELD	M AE T F IY L D
MATHERVILLE	M AH TH AH R V AH L
MATHISTON	M AE TH IH S T AO N
MATHISTOWN	M AE TH IH S T OW N
MATTAPAN	M AE T AH P AE N
MATTAPOISETT	M AE T AH P OY S AH T
MATTAWA	M AE T AH AH
MATTAWAMKEAG	M AE T AH AH M K IY G
MATTAWAN	M AE T AH W AA N
MATTITUCK	M AE T AH T AH K
MATTYDALE	M AE T IY D EY L
MAUCKPORT	M AO K AH R T
MAUGANSVILLE	M AH G AE N S V AH L
MAUJER	M AO JH AH R
MAUMELLE	M AO M AH L
MAUNALOA	M AH N AE L OW AH
MAUREPAS	M AO R AH P AH Z
MAURERTOWN	M AO R AH R T OW N
MAUSTON	M AO S T AH N
MAVISDALE	M AE V AH Z D EY L
MAWAL	M AO AH L
MAXBASS	M AE K S B AH S
MAXMILLAN	M AE K S M IH L AH N
MAXWELTON	M AE K S W EH L T AH N
MAYBELL	M EY B EH L
MAYBROOK	M EY B R UH K
MAYERSVILLE	M EY AH R S V AH L
MAYETTA	M EY EH T AH
MAYFIE	M EY F AY
MAYHILL	M EY HH IH L
MAYLENE	M EY L IY N
MAYNARDVILLE	M EY N AA R D AH L
MAYODAN	M EY AH D AH N
MAYPEARL	M EY P ER L
MAYPORT	M EY P OW R T
MAYSEL	M EY S AH L
MAYSVILLE	M EY Z AH L
MAYVIEW	M EY V Y UW
MAYWOOD	M EY W UH D
MAZAMA	M AE Z AH M AH
MAZEAU	M EY Z IY UW
MAZEPPA	M AH Z EH P AH
MAZOMANIE	M AE Z AH M EY N AY
MCALESTER	M K EY L EH S T AH R
MCCLUSKY	M K L AH S IY
MCCOOLE	M K UW L
MCCURTAIN	M K AH R T EY N
MCMINNVILLE	M K M IH N V AH L
MD	EH M D
MEADOWBROOK	M EH D OW B R UH K
MEADOWVIEW	M EH D OW V Y UW
MEADVIEW	M IY D V Y UW
MEADVILLE	M IY D AH L
MEAGAN	M IY AH JH AH N
MEALLY	M IY L IY
MEANSVILLE	M IY N S V AH L
MECHANICSTOWN	M IH K AE N IH K S T AW N
MECHANICSVILLE	M EH CH AH N IH K S V AH L
MECHANICVILLE	M EH CH AH N IH K V AH L
MECHEN	M EH CH AH N
MECKLING	M EH K L AH NG
MECOSTA	M AH K AA S T AH
MEDARYVILLE	M AH D AE R AH V AH L
MEDDYBEMPS	M EH D AH B AH M P S
MEDFIELD	M IY D F IY L D
MEDIAPOLIS	M IY D IY AE P AH L AH S
MEDIMONT	M EH D AH M AH N T
MEDINAH	M EH D AH N AH
MEDOMAK	M EH D AH M AH K
MEDON	M IY D AO N
MEDWAY	M IY D W EY
MEETEETSE	M IY T IY T S
MEGGETT	M EH JH AH T
MEHERRIN	M AH HH EH R AH N
MEHOOPANY	M AH HH UW P AH N IY
MEIGS	M EY G Z
MEINRAD	M IY N R AH D
MEKINOCK	M EH K AH N AH K
MEKORYUK	M AH K AO R AY AH K
MELBER	M EH L B AH R
MELCHER-DALLAS	M EH L CH ER D AE L AH S
MELCROFT	M EH L K R AH F T
MELFA	M EH L F AH
MELLETTE	M EH L EH T
MELLWOOD	M EH L W UW D
MELMORE	M EH L M AH R
MELRUDE	M EH L R UW D
MELVERN	M EH L V AH R N
MELVINDALE	M EH L V AH N D EY L
MELYN	M EH L AH N
MEM	M EH M
MENAGH	M EH N AH
MENAHAN	M EH N AH AH N
MENAHGA	M EH N AH G AH
MENAN	M IY N AH N
MENASHA	M EH N AH SH AH
MENDHAM	M EH N D HH AE M
MENDON	M EH N D AO N
MENNO	M EH N OW
MENOKEN	M EH N AH K AH N
MENOMINEE	M EH N AH M AH N IY IY
MENOMONEE	M EH N AH M AH N IY IY
MENOMONIE	M EH N AH M OW N AY
MENTONE	M EH N T OW N
MEPPEN	M EH P AH N
MERAUX	M EH R AH K S
MERCERSBURG	M AH R S AH R S B AH R G
MERCERVILLE	M AH R S AH R V AH L
MERCHANTVILLE	M AH R CH AE N T V AH L
MEREPOINT	M IH ER P OY N T
MERETA	M EH R AH T AH
MERIBROOK	M AH R IH B R AH K
MERIDALE	M IH ER AH D EY L
MERIDIANVILLE	M EH R AH D IY AE N V AH L
MERIGOLD	M EH R AH G OW L D
MERILIND	M EH R AH L AY N D
MERILINE	M EH R AH L AY N
MERILLON	M AH R IH L AH N
MERIVALE	M EH R AH V EY L
MEROM	M EH R AH M
MERRICOURT	M EH R AH K OW R T
MERRILLAN	M EH R IH L AH N
MERRILLVILLE	M EH R IH L V AH L
MERRIONETTE	M EH R IY AH N EH T
MERRISON	M EH R IY Z AO N
MERRITTSTOWN	M EH R AH T S T OW N
MERRYMOUNT	M EH R IY M AW N T
MERSELES	M AH R S IY L Z
MERSELIS	M AH R S AH L AH S
MERTZON	M AH R T S AH N
MERTZTOWN	M AH R T S T OW N
MERWICK	M AH R W AH K
MESEREAU	M AH S IY R IY UW
MESHOPPEN	M IY Z HH AA P AH N
MESILLA	M AH S IH L AH
MESITA	M EH S AH T AH
METALINE	M EH T AH L AY N
METAMORA	M AH T AE M AH R AH
METHOW	M EH TH OW
METHUEN	M EH T HH Y UW AH N
METROPARK	M EH T R OW P AA R K
METROTECH	M EH T R AH T AH K
METUCHEN	M EH T AH CH AH N
MEWS	M Y UW Z
MEXIA	M EH K S IY AH
MEYERSDALE	M EY AH R S D EY L
MEYERSVILLE	M EY AH R S V AH L
MEYRAN	M EY R AH N
MIAMISBURG	M AY AH M IH Z AH R G
MICHIGAMME	M IH CH AH G AH M
MICHIGANTOWN	M AH CH IH G AH N T OW N
MICIELI	M AH S IY L IY
MICKARDAN	M IH K AA R D AH N
MICKLETON	M IH K L AH T AH N
MICO	M IH K OW
MICROLAB	M AY K R OW L AE B
MIDDAGH	M IH D AH
MIDDLEBORO	M IH D L EH B AH R OW
MIDDLEBOURNE	M IH D L AH B OW R N
MIDDLEBURGH	M IH D L AH B AH R
MIDDLEFIELD	M IH D AH L F IY L D
MIDDLEGROVE	M IH D AH L G R OW V
MIDDLEMAY	M IH D AH L M EY
MIDDLEPORT	M IH D AH L P OW R T
MIDDLESBORO	M IH D L EH Z AH R OW
MIDDLEVILLE	M IH D L AH V AH L
MIDFIELD	M IH D F IY L D
MIDLOTHIAN	M IH D L AA TH IY AH N
MIDPARK	M IH D P AA R K
MIDPINES	M IH D P AY N Z
MIDSTREAMS	M IH D S T R IY M Z
MIDVALE	M IH D V EY L
MIDVILLE	M IH D AH L
MIDWOOD	M IH D W UH D
MIFFLINBURG	M IH F L IH N B AH R G
MIFFLINTOWN	M IH F L IH N T OW N
MIFFLINVILLE	M IH F L IH N V AH L
MIHIEL	M AH HH IY L
MILACA	M IH L AH K AH
MILANVILLE	M AH L AE N V AH L
MILBRIDGE	M IH L B R IH JH
MILDEN	M AY L D AH N
MILEED	M AY L D
MILESES	M AY L Z IH Z
MILESVILLE	M AH L EH Z AH L
MILILANI	M AH L IH L AH N IY
MILLADORE	M IH L AH D OW R
MILLBORO	M IH L B AH R OW
MILLBRAE	M IH L B R EY
MILLBRIDGE	M IH L B R IH JH
MILLBROKE	M IH L B R OW K
MILLBROOK	M IH L B R UH K
MILLBROOKE	M IH L B R AH K
MILLBURY	M IH L B EH R IY
MILLCREEK	M IH L K R IY K
MILLEDGEVILLE	M IH L EH JH AH V AH L
MILLERSBURG	M IH L AH R S B AH R G
MILLERSPORT	M IH L ER S P OW R T
MILLERSTOWN	M IH L ER Z T AW N
MILLERSVIEW	M IH L ER Z V Y UW
MILLERSVILLE	M IH L AH R S V AH L
MILLERTON	M IH L ER T AH N
MILLERVILLE	M IH L AH R V AH L
MILLFIELD	M IH L F IY L D
MILLHEIM	M IH L HH IY M
MILLINOCKET	M IH L AH N AA K AH T
MILLMONT	M IH L M AH N T
MILLPORT	M IH L P OW R T
MILLRIFT	M IH L R IH F T
MILLRY	M IH L R IY
MILLSBORO	M IH L S B AH R OW
MILLSTADT	M IH L S T AH D T
MILLSTREAM	M IH L S T R IY M
MILLTOWN	M IH L T AW N
MILLVALE	M IH L V EY L
MILLVILLE	M IH L V AH L
MILMAY	M IH L M EY
MILMINE	M IH L M AY N
MILNESAND	M IH L N AH S AH N D
MILTONA	M IH L T AH N AH
MILTONVALE	M IH L T AH N V EY L
MILWAUKIE	M IH L W AH K AY
MIMBRES	M IH M B AH R Z
MINATARE	M IH N AH T AH R
MINBURN	M IH N B AH R N
MINCHUMINA	M IH NG K Y UW M AH N AH
MINCO	M IH NG K OW
MINDENMINES	M AY N D AH N M AY N Z
MINDORO	M IH N D AH R OW
MINERALWELLS	M IH N AH R AH L W EH L Z
MINERSVILLE	M AH N AH R S V AH L
MINETTA	M AH N EH T AH
MINEVILLE	M IH N AH V AH L
MINFORD	M IH N F AH R D
MINIDOKA	M AH N AH D OW K AH
MINNEHAHA	M IH N EH HH AH HH AH
MINNEOTA	M IH N IY AH T AH
MINNEWAUKAN	M IH N Y UW AH K AH N
MINNIEFORD	M IH N IY F AH R D
MINNISINK	M IH N AH S AH NG K
MINNORA	M IH N AH R AH
MINOA	M IH N OW AH
MINOCQUA	M AH N AA K W AH
MINONG	M IH N AH NG
MINONK	M IH N AH NG K
MINOOKA	M IH N AH K AH
MINOTOLA	M AH N AA T AH L AH
MINTHORNE	M IH N TH AH R N
MINUE	M IH N UW
MIO	M AY OW
MIRAMONTE	M IH R AH M AH N T
MIRLINDA	M AH R L IH N D AH
MISERICO	M AH S EH R AH K OW
MISHICOT	M IH S IH K AH T
MITCHELLS	M IH CH AH L Z
MITCHELLVILLE	M AH CH EH L V AH L
MITTIE	M IH T AY
MIZPAH	M IH Z P AH
ML	EH M L
MLK	EH M EH L K
MNR	EH M EH N R
MOBEETIE	M AA B IY T AY
MOBJACK	M AA B JH AE K
MOBRIDGE	M AA B R IH JH
MOCANAQUA	M AA K AH N AE K W AH
MOCKSVILLE	M AA K S V AH L
MOCLIPS	M AA K L AH P S
MODALE	M AH D EY L
MODOC	M AA D AH K
MOGADORE	M AA G AH D AH R
MOHAVE	M AH HH EY V
MOHEGAN	M AA HH AH G AH N
MOHNTON	M AA N T AH N
MOHONK	M AA HH AH NG K
MOHRSVILLE	M AA R S V AH L
MOIESE	M OY IY Z
MOILLE	M OY L
MOKANE	M AH K EY N
MOKELUMNE	M AA K AH L AH M
MOKENA	M AA K AH N AH
MOKO	M OW K OW
MOLALLA	M AH L AE L AH
MOLENA	M AA L AH N AH
MOLINOS	M AA L AH N AH Z
MOMENCE	M AA M AH N S
MONACA	M AA N AH K AH
MONAHANS	M AA N AH HH AH N Z
MONANGO	M AH N AE N G OW
MONCLOVA	M AO NG K L AH V AH
MONCRIFF	M AO NG K R AH F
MONDAMIN	M AA N D AH M AH N
MONEE	M OW N IY IY
MONETA	M AA N AH T AH
MONETTA	M AH N EH T AH
MONGAUP	M AA N G AH P
MONHEGAN	M AA N HH AH G AH N
MONON	M AA N AH N
MONONA	M AA N AH N AH
MONONGAH	M AH N AA N G AH
MONROETON	M AA N R OW AH T AH N
MONTALBA	M AA N T AE L B AH
MONTANDON	M AA N T AE N D AH N
MONTAUK	M AA N T AH K
MONTEAGLE	M AA N T IY G AH L
MONTECITO	M AA N T EH S AH T OW
MONTEGUT	M AA N T IY G AH T
MONTELL	M AA N T AH L
MONTERVILLE	M AA N T AH R V AH L
MONTEVALLO	M AA N T AH V AE L OW
MONTEVIEW	M AA N T IY V Y UW
MONTGOMERYVILLE	M AA N T G AH M EH R AH V AH L
MONTOUR	M AA N T AH R
MONTOURSVILLE	M AA N T AH R S V AH L
MONTVERDE	M AA N T V AH R D
MOODUS	M UW D AH S
MOOLEYVILLE	M UW L EY V AH L
MOONACHIE	M UW N EY K IY
MOORELAND	M UW R IY L AE N D
MOORESBORO	M AH R EH Z AH R OW
MOORESBURG	M AH R EH Z AH R G
MOORESVILLE	M AH R EH Z AH L
MOORETON	M UW R IY T AH N
MOOREVILLE	M UH R AH V AH L
MOORINGSPORT	M UW R IH NG S P OW R T
MOORLYN	M UH R L AH N
MOORPARK	M UH R P AA R K
MOORSLEIGH	M UH R S L EY
MOOSEHEART	M UW S AH HH AH R T
MOOSIC	M UW S IH K
MOOSUP	M UW S AH P
MOQUAH	M AA K W AH
MORANI	M AO R AH N IY
MORAVIA	M AH R EY V IY AH
MOREAUVILLE	M AO R IY UW V AH L
MORENCI	M AH R EH N S IY
MORETOWN	M AO R AH T OW N
MORGANTON	M AO R G AE N T AH N
MORGANVILLE	M AO R G AE N V AH L
MORGANZA	M AO R G AE N Z AH
MORIAH	M AO R AY AH
MORIAS	M AO R IY AH Z
MORICHES	M AO R AH CH AH Z
MORLOT	M AO R L AH T
MORNINGSIDE	M AO R N IH NG S AY D
MORONGO	M AH R AA N G OW
MORRAL	M AO R AH L
MORRICE	M AO R AH S
MORRIL	M AO R AH L
MORRILTON	M AO R IH L T AH N
MORRISDALE	M AO R AH S D EY L
MORRISONVILLE	M AO R AH S AA N V AH L
MORRISSEE	M AO R AH S IY
MORRISTON	M AO R AH S T AH N
MORRISVALE	M AO R AH S V EY L
MORROWS	M AA R OW Z
MORROWVILLE	M AO R OW V AH L
MORSETOWN	M AO R S AH T OW N
MORVIN	M AO R V AH N
MOSHANNON	M AH SH AE N AH N
MOSHEIM	M AH SH IY M
MOSHOLU	M AA SH AH L UW
MOSSHILL	M AO S HH IH L
MOSSYROCK	M AO S IY R AA K
MOULTONBOROUGH	M OW L T AA N B AH R UW
MOUNDHOUSE	M AW N D HH AW S
MOUNDRIDGE	M AW N D R IH JH
MOUNDSVILLE	M AW N D S V AH L
MOUNDVILLE	M AW N D V AH L
MOUNTAI	M AW N T EY
MOUNTAINAIR	M AW N T AH N EH R
MOUNTAINBURG	M AW N T EY N B AH R G
MOUNTAINVIEW	M AW N T AH N V Y UW
MOUNTLAKE	M AW N T L EY K
MOUNTVILLE	M AW N T V AH L
MOUSIE	M AW S IY
MOUTHCARD	M AW TH K AA R D
MOVILLE	M AA V AH L
MOXEE	M AA K S IY IY
MOYEN	M OY AH N
MOYIE	M OY AY
MOYOCK	M OY AH K
MOZIER	M AA Z AY AH R
MRYTLE	M R IH T AH L
MSU	M Z UW
MT.	EH M T IY
MTN	EH M T IY N
MUHLEBACH	M AH L AH B AH CH
MUHLENBRINK	M AH L EH N B R AH NG K
MUKILTEO	M Y UW K IH L T IY OW
MUKWONAGO	M AH K W AA N AH G OW
MULESHOE	M Y UW L SH UW
MULINER	M Y UW L AY N AH R
MULINO	M Y UW L AH N OW
MULKEYTOWN	M UH L K AH T OW N
MULLICA	M UH L AH K AH
MULLINVILLE	M UH L IH N V AH L
MULVANE	M UH L V EY N
MUNDELEIN	M AH N D AH L IY N
MUNDET	M AH N D AH T
MUNFORDVILLE	M AH N F AO R D AH L
MUNHALL	M AH N HH AH L
MUNITH	M Y UW N AH TH
MUNNSVILLE	M AH N S V AH L
MUNSONVILLE	M AH N S AA N V AH L
MURDO	M AH R D OW
MURFREESBORO	M AH R F R IY Z AH R OW
MURIETA	M Y AH R IY T AH
MURPHYSBORO	M AH R F IH Z AH R OW
MURRAYSVILLE	M AH R EY Z AH L
MURRAYVILLE	M AH R EY V AH L
MURRELLS	M AH R AH L Z
MURRYSVILLE	M AH R IH Z AH L
MUSCADINE	M AH S AH D AY N
MUSCODA	M AH S AH D AH
MUSCOTAH	M AH S AH T AH
MUSCOY	M AH S OW IY
MUSELLA	M Y UW S EH L AH
MUSKEGO	M AH S AH G OW
MUSSELSHELL	M AH S AH L SH EH L
MUSSEY	M AH S IY
MYAKKA	M AY AE K AH
MYERSTOWN	M AY AH R S T OW N
MYERSVILLE	M AY AH R S V AH L
MYLO	M IH L OW
MYTON	M IH T AH N
N.J.	EH N JH EY
NAALEHU	N AA L AH HH UW
NACOOCHEE	N AE K AH CH IY IY
NAEC	N IY K
NAF	N AE F
NAGOG	N AE G AH G
NAHANT	N AE AH N T
NAHUNTA	N AH HH AH N T AH
NAKINA	N AE K AH N AH
NAKNEK	N AE K N AH K
NAMEOKE	N EY M IY OW K
NAMPA	N AE M P AH
NANJEMOY	N AE N JH EH M OW IY
NANSEN	N AE N Z AH N
NANSON	N AE N S AH N
NANTICOKE	N AE N T AH K OW K
NANTY	N AE N T IY
NANUET	N AE N Y UW AH T
NAPAKIAK	N AH P EY K IY AH K
NAPANOCH	N AE P AH N AH CH
NAPER	N AE P ER
NAPFOR	N AE P F AO R
NAPOLEONVILLE	N AH P OW L IY AA N V AH L
NAPONEE	N AE P AO N IY
NAPPANEE	N AE P EY N IY
NAPTON	N AE P T AH N
NARBERTH	N AA R B AH R TH
NARDIN	N AA R D AH N
NARKA	N AA R K AH
NARRATICON	N AE R EY T IH K AO N
NARROWSBURG	N AE R OW S B AH R G
NARVON	N AA R V AH N
NAS	N AE Z
NASELLE	N AE S AH L
NASHOBA	N AE SH AH B AH
NASHOTAH	N AE SH AH T AH
NASHPORT	N AE SH AH R T
NASHWAUK	N AE SH W AH K
NATHROP	N AE TH R AH P
NATIONA	N EY T IY AH N AH
NATOMA	N AE T AH M AH
NATRONA	N AE T R AH N AH
NATURITA	N AE T Y UH R AH T AH
NAUBINWAY	N AH B IH N W EY IY
NAUVOO	N AO V UW
NAVARINO	N AH V AE R AH N OW
NAVASINK	N AE V AH S AH NG K
NAVASOTA	N AH V AE S AH T AH
NAVESINK	N AE V AH S AH NG K
NAWC	N AO K
NAYTAHWAUSH	N EY T AE W AH SH
NAZIANZ	N EY Z IY AH N Z
NB	EH N B
NEALS	N IY L Z
NEBAGAMON	N AH B AE G AH M AH N
NEBO	N EH B OW
NEBOH	N EH B OW
NECEDAH	N EH S AH D AH
NECHE	N EH CH
NECHES	N EH CH AH Z
NECKAR	N EH K ER
NEDRA	N EH D R AH
NEEDMORE	N IY D M AH R
NEEDVILLE	N IY D AH L
NEELYTON	N IY L AH T AH N
NEELYVILLE	N IY L AH V AH L
NEENAH	N IY N AH
NEESES	N IY Z AH Z
NEFFSVILLE	N EH F S V AH L
NEGAUNEE	N EH G AH N IY IY
NEGUNDO	N AH G AH N D OW
NEHALEM	N EH HH AH L AH M
NEHAWKA	N EH HH AH K AH
NEIHART	N IY HH AH R T
NEILLSVILLE	N IY L S V AH L
NEKOMA	N EH K AH M AH
NELIGH	N EH L IY
NELSONVILLE	N EH L S AA N V AH L
NEMAHA	N EH M AH HH AH
NENANA	N EH N AH N AH
NEODESHA	N IY OW D AH SH AA
NEOGA	N IY AH G AA
NEOPIT	N IY OW P IH T
NEOSHO	N IY AH SH OW
NEOTSU	N IY OW T S UW
NEPHI	N EH F IY
NEPONSIT	N AH P AA N S AH T
NEPTON	N EH P T AH N
NEREID	N IY R IY D
NERSTRAND	N AH R S T R AH N D
NESCONSET	N EH S AA N S AH T
NESCOPECK	N EH S AH P AH K
NESHANIC	N EH SH AH N AH K
NESHANNOCK	N AH SH AE N AH K
NESHKORO	N EH SH AH R OW
NESKOWIN	N EH S OW AH N
NESMYTHE	N EH Z M AH DH
NESQUEHONING	N EH S W AH HH OW N AH NG
NESTO	N EH S T OW
NESTRO	N EH S T R OW
NETAWAKA	N AH T AO AH K AH
NETCONG	N EH T AH NG
NETHERWOOD	N EH DH ER W UH D
NEVERSINK	N EH V ER Z IH NG K
NEVINVILLE	N AH V IH N V AH L
NEVISDALE	N EH V AH Z D EY L
NEWALLA	N Y UW AE L AH
NEWAYGO	N Y UW EY G OW
NEWBERNE	N Y UW B AH R N
NEWBURYPORT	N UW B EH R IY P OW R T
NEWCOMERSTOWN	N UW K AH M ER Z T AW N
NEWDALE	N UW D EY L
NEWEL	N UW AH L
NEWELLTON	N Y UW EH L T AH N
NEWFANE	N Y UW F EY N
NEWFOLDEN	N UW F OW L D AH N
NEWHEBRON	N Y UW HH EH B R AH N
NEWHOPE	N UW HH OW P
NEWINGTON	N UW IH NG T AH N
NEWLLANO	N Y UW L AH N OW
NEWMANSTOWN	N UW M AE N Z T AW N
NEWMANSVILLE	N Y UW M AE N S V AH L
NEWNAN	N Y UW N AH N
NEWNATA	N Y UW N AH T AH
NEWRY	N UW R IY
NEWSOMS	N Y UW S AH M Z
NEWTONVILLE	N Y UW T AA N V AH L
NEWVALE	N UW V EY L
NEZPERCE	N EH Z P AH R S
NH	EH N
NIANGUA	N AY AE N G W AH
NIANTIC	N AY AH N T AH K
NIARADA	N AY AE R AH D AH
NICASIO	N AH K EY S IY OW
NICEVILLE	N IH S AH V AH L
NICHOLASVILLE	N IH CH AH L AE Z AH L
NICHOLVILLE	N AH CH OW L V AH L
NICKELSVILLE	N IH K EH L S V AH L
NICKTOWN	N IH K T AW N
NICOLLET	N AH K AA L AH T
NICUT	N IH K AH T
NIDO	N IH D OW
NIELSVILLE	N IY L S V AH L
NIETOS	N IY T AH Z
NIKOLAEVSK	N IH K AH L IY V S K
NIKOLSKI	N AH K OW L S IY
NILWOOD	N IH L W UW D
NINEPOINTS	N AY N P OY N T S
NINILCHIK	N AH N IH L CH AH K
NINNEKAH	N IH N AH K AH
NINOLE	N AH N OW L
NIOTA	N AY AH T AH
NIOTAZE	N AY AH T EY Z
NIPOMO	N IH P AH M OW
NIPPA	N IH P AH
NIPTON	N IH P T AH N
NISKAYUNA	N IH S EY UW N AH
NISLAND	N IH Z L AH N D
NISULA	N AH S UW L AH
NIVERVILLE	N AH V AH R V AH L
NIXA	N IH K S AH
NJ	EH N JH
NJDOT	N JH D AA T
NJT	EH N JH EY T
NO.	N OW
NOAHS	N OW Z
NOATAK	N OW T AH K
NOBE	N OW B
NOBLEBORO	N AA B L EH B AH R OW
NOBLESTOWN	N OW B AH L AH S T OW N
NOBLESVILLE	N AA B L EH Z AH L
NOCONA	N AA K AH N AH
NOCTOR	N AA K T AH R
NODAWAY	N AA D AH W EY
NOGAL	N OW G AH L
NOKESVILLE	N AH K EH Z AH L
NOKOMIS	N AA K AH M AH S
NOLANS	N AA L AH N Z
NOLANVILLE	N AH L AE N V AH L
NOLENSVILLE	N AH L EH N S V AH L
NOMINI	N AA M AH N IY
NONDALTON	N AA N D AE L T AH N
NOORVIK	N UH R V AH K
NORBORNE	N AO R B AH R N
NORBURYS	N AO R B Y AH R AH Z
NORCATUR	N AO R K AH T AH R
NORDACS	N AO R D AH S
NORDHEIM	N AO R D HH IY M
NORDLAND	N AO R D L AH N D
NORFORK	N AO R F AH R K
NORLINA	N AO R L AH N AH
NORMALEE	N AO R M AH L IY
NORMALVILLE	N AO R M AE L V AH L
NORMANTOWN	N AO R M AE N T OW N
NOROTON	N AO R AH T AH N
NORPHLET	N AO R F L AH T
NORRIDGE	N AO R AH JH
NORRIDGEWOCK	N AO R IH JH UW AH K
NORRISTOWN	N AO R AH S T OW N
NORTHBORO	N AO R TH B AH R OW
NORTHBOROUGH	N AO R TH B ER OW
NORTHBRIDGE	N AO R TH B R IH JH
NORTHENTRY	N AO R TH AH N T R IY
NORTHFORD	N AO R TH F OW R D
NORTHGLENN	N AO R TH G L AH N
NORTHLAKE	N AO R TH L EY K
NORTHMONT	N AO R TH M AH N T
NORTHOME	N AO R TH OW M
NORTHPOINT	N AO R TH P OY N T
NORTHPORT	N AO R TH P OW R T
NORTHSIDE	N AO R TH S AY D
NORTHUMBERLAND	N AO R TH AH M B ER L AE N D
NORTHVILLE	N AO R TH V AH L
NORTHWOODS	N AO R TH W UH D Z
NORTONVILLE	N AO R T AA N V AH L
NOS	N OW Z
NOSTER	N AA S T AH R
NOTASULGA	N AA T AH S AH L G AH
NOTI	N OW T IY
NOTTINGHILL	N AA T IH NG HH IH L
NOTUS	N OW T AH S
NOWATA	N OW AH T AH
NOXAPATER	N AA K S AH P EY T AH R
NOXEN	N AA K S AH N
NS	EH N S
NUCLA	N AH K L AH
NUIQSUT	N UW K S AH T
NULATO	N Y UW L AH T OW
NUMA	N Y UW M AH
NUNDA	N AH N D AH
NUNICA	N Y UW N AH K AH
NUNNINK	N AH N AH NG K
NUNZIE	N AH N Z AY
NURGE	N AH R JH
NUTWOOD	N AH T W UH D
NUVERN	N Y UW V AH R N
NWC	EH N D AH B AH L Y UW K
NWK	EH N D AH B AH L Y UW K
NY	N AY
NYS	N IH Z
NYU	N AY UW
OAKBORO	OW K B AH R OW
OAKCREST	OW K R EH S T
OAKDENE	OW K D IY N
OAKESDALE	OW K AH Z D EY L
OAKFIELD	OW K F IY L D
OAKFORD	OW K F OW R D
OAKHAM	OW K HH AE M
OAKHILL	OW K HH IH L
OAKHURST	OW K AH R S T
OAKLANDON	OW K L AE N D AO N
OAKLYN	OW K L AH N
OAKMOOR	OW K M UH R
OAKTON	OW K T AH N
OAKTOWN	OW K T AW N
OARK	OW R K
OBAL	OW B AH L
OBAN	OW B AH N
OBION	OW B IY AH N
OBRE	AA B AH R
OCATE	OW K EY T
OCEANO	OW S IY N OW
OCEANPORT	OW SH AH N P OW R T
OCHELATA	AH CH EH L AH T AH
OCHEYEDAN	AH CH EY AH D AH N
OCHLOCKNEE	AA K L AH K N IY IY
OCHOPEE	AA CH AH P IY IY
OCKLAWAHA	AA K L AO AH HH AH
OCOEE	AA K OW IY IY
OCONEE	AA K AH N IY IY
OCONOMOWOC	AA K AH N AA M OW AH K
OCONTO	AH K AA N T OW
ODEBOLT	AA D AH B OW L T
ODENTON	AH D EH N T AH N
ODENVILLE	AH D EH N V AH L
ODON	AA D AH N
OELRICHS	OW EH L R AH CH S
OELWEIN	OW AH L W IY N
OFFERLE	AA F AH R L
OGALLAH	AH G AE L AH
OGALLALA	AH G AE L AH L AH
OGDENSBURG	AA G D EH N S B AH R G
OGEMA	AA JH AH M AH
OGONTZ	AA G AH N T S
OGUNQUIT	AH G AH NG K W AH T
OHATCHEE	AA HH AH CH IY IY
OHILLS	AA HH AH L Z
OHIOPYLE	AA HH IY AH P AY L
OHIOWA	AH HH IY OW AH
OILVILLE	OY L V AH L
OJAI	AA JH EY
OJO	AA JH OW
OJUS	OW JH AH S
OKABENA	AH K AE B AH N AH
OKAHUMPKA	AA K AH HH AH M P AH
OKANOGAN	AH K AE N AH G AH N
OKARCHE	AA K AH R K
OKATON	AA K AH T AH N
OKAUCHEE	AA K AH CH IY IY
OKAWVILLE	AA K AH V AH L
OKEANA	OW K IY N AH
OKEENE	OW K IY N
OKEFENOKEE	AH K EH F AH N AH K IY IY
OKEMOS	AA K AH M AH Z
OKETO	AA K AH T OW
OKLAUNION	AA K L AO N IY AH N
OKLEE	AA K L IY IY
OKMULGEE	AA K M AH L JH IY IY
OKNER	AA K N AH R
OKOBOJI	AH K AA B AH JH IY
OKOLONA	AH K AA L AH N AH
OKTAHA	AA K T AH HH AH
OLALLA	AH L AE L AH
OLANTA	AH L AE N T AH
OLAR	OW L AH R
OLATON	AA L AH T AH N
OLDFORT	OW L D F OW R T
OLDIS	OW L D IY Z
OLDTOWN	OW L D T AW N
OLINVILLE	AH L IH N V AH L
OLIVEBURG	AH L IH V AH B AH R G
OLIVEHILL	AA L IH V HH IH L
OLIVEHURST	AH L IH V AH HH AH R S T
OLIVEREA	AA L AH V IY R IY AH
OLIVET	AA L AH V AH T
OLLA	AA L AH
OLMSTED	OW L M S T AH D
OLMSTEDVILLE	OW L M S T EH D AH L
OLPE	OW L P
OLSBURG	OW L S B AH R G
OLTON	OW L T AH N
OLUSTEE	AA L AH S T IY IY
OLYPHANT	AA L AH F AH N T
OMAK	AA M AH K
OMRO	AA M R OW
ONAGA	AA N AH G AH
ONAKA	AA N AH K AH
ONALASKA	AA N AH L AE S AH
ONAMIA	AH N EY M IY AH
ONANCOCK	AH N AE NG K AH K
ONARGA	AH N AA R G AH
ONAWAY	AO N AH W EY
ONCHIOTA	AO NG K IY AH T AH
ONDERONK	AA N D AH R AH NG K
ONEGO	AO N IY G OW
ONEKAMA	AH N EH K AH M AH
ONEMO	AA N AH M OW
ONEONTA	OW N IY AA N T AH
ONGE	AA N JH
ONIA	OW N Y AH
ONIDA	AA N AH D AH
ONSTED	AO N Z T EH D
ONTONAGON	AA N T AA N AH G AH N
OOKALA	UH K AH L AH
OOLITIC	UW L AH T AH K
OOLOGAH	UW L AH G AH
OOLTEWAH	UW L T Y UW AH
OOSTBURG	UW S T B AH R G
OPA	AA P AH
OPELIKA	AH P EH L AH K AH
OPELOUSAS	AA P AH L AW S AH Z
OPENVIEW	OW P AH N V Y UW
OPHIR	AA F AH R
OPP.	AA P
OQUAWKA	AA K W AH K AH
ORAB	AO R AH B
ORADELL	AO R AH D AH L
ORANGEVALE	AO R IH N JH V EY L
ORANGEVILLE	AH R AE N JH AH V AH L
ORATON	AO R AH T AH N
ORBISONIA	AO R B AH S OW N Y AH
ORDELL	AO R D AH L
ORDEN	AO R D AH N
ORDERVILLE	AO R D AH R V AH L
OREANA	AH R IY N AH
OREFIELD	OW R F IY L D
OREGONIA	AO R AH G OW N Y AH
ORELAND	OW R L AE N D
ORETECH	AO R AH T AH K
ORFORDVILLE	AO R F AO R D AH L
ORGAS	AO R G AH Z
ORIENTA	AH R IY N T AH
ORISKA	AH R IH S AH
ORISKANY	AH R IH S AH N IY
ORLINDA	AO R L IH N D AH
ORLO	AO R L OW
ORMY	AO R M IY
OROFINO	AH R AA F AH N OW
ORONDO	AH R AA N D OW
ORONO	AO R AH N OW
ORONOCO	AH R AA N AH K OW
ORONOGO	AH R AA N AH G OW
OROSI	AO R AH S IY
OROVADA	AH R AA V AH D AH
OROVILLE	AO R AH V AH L
ORRINGTON	AO R IH NG T AH N
ORRS	AO R Z
ORRSTOWN	AO R S T OW N
ORRTANNA	AO R T AE N AH
ORRUM	AO R AH M
ORRVILLE	AO R V AH L
ORTING	AO R T AH NG
ORTLEY	AO R T L IY
ORTONVILLE	AO R T AA N V AH L
ORVISTON	AO R V IH S T AH N
ORWIGSBURG	AO R W IH G S B AH R G
OSAKIS	AA S AH K AH S
OSAWATOMIE	AA S AH AH T OW M AY
OSBORNSVILLE	AA Z AO R N S V AH L
OSCODA	AA S AH D AH
OSHOTO	AA SH AH T OW
OSKALOOSA	AA S AH L UW S AH
OSNABROCK	AA S N AE B R AA K
OSO	AA S OW
OSOS	AA S AA S
OSSEO	AA S IY OW
OSSIAN	AA S IY AH N
OSSINEKE	AA S IH N IY K
OSSINING	AA S AY N IH NG
OSSIPEE	AA S IH P IY
OSTEND	AA S T EH N D
OSTERVILLE	AA S T AH R V AH L
OSTWOOD	AA S T W UW D
OSWAYO	AA S W EY OW
OSWEGATCHIE	AA S W EH G AH CH AY
OSYKA	AA S AH K AH
OTEGO	AA T AH G OW
OTHO	AA TH OW
OTISCO	AH T IH S OW
OTISVILLE	AH T IH Z AH L
OTLEY	AA T L IY
OTO	AA T OW
OTOE	AA T OW
OTSELIC	AA T S AH L AH K
OTTAVIO	AA T EY V IY OW
OTTERBIEN	AA T ER B AY AH N
OTTERTAIL	AA T ER T EY L
OTTERVILLE	AA T AH R V AH L
OTTOVILLE	AA T AH V AH L
OTTSVILLE	AA T S V AH L
OTTUMWA	AA T AH M W AH
OTWAY	AA T W EY IY
OUAQUAGA	AW AE K W AH G AH
OUEN	AW AH N
OURAY	AH R EY IY
OUTERBRIDGE	AW T ER B R IH JH
OUTWATER	AW T W AO T ER
OVALO	AA V AH L OW
OVANDO	AH V AE N D OW
OVAPA	AA V AH P AH
OVAS	OW V AH Z
OVERBROOK	OW V ER B R UH K
OVERHILL	OW V ER HH IH L
OVERING	OW V ER IH NG
OVID	AA V AH D
OVILLA	AH V IH L AH
OVINGTON	AH V IH N G T AH N
OVIS	OW V AH S
OWANECO	OW AE N AH K OW
OWANKA	OW AE NG K AH
OWASCO	OW AE S OW
OWASSO	OW AE S OW
OWATONNA	OW AH T AA N AH
OWEGO	OW G OW
OWENDALE	OW AH N D EY L
OWENSBURG	OW EH N S B AH R G
OWENSVILLE	OW EH N S V AH L
OWENTON	OW AH N T AH N
OWINGSVILLE	OW IH N G S V AH L
OXHOLM	AA K S OW L M
OXLY	AA K S L IY
OXON	AA K S AO N
OZAN	OW Z AH N
OZAWKIE	AA Z AH K AY
OZONA	AA Z AH N AH
PAAUHAU	P AA AH HH AH
PAAUILO	P AA UW L OW
PACHUTA	P AH CH UW T AH
PACKANACK	P AE K AH N AH K
PACOLET	P AE K AH L AH T
PADANARAM	P AH D AE N AH R AH M
PADRONI	P AE D R AH N IY
PAEONIAN	P IY OW N IY AH N
PAERDEGAT	P IY R D AH G AH T
PAGELAND	P EY JH L AE N D
PAGOSA	P AE G AH S AH
PAHALA	P AE HH AH L AH
PAHOA	P AE HH OW AH
PAHOKEE	P AE HH AH K IY IY
PAHRUMP	P AE R AH M P
PAIA	P EY AH
PAICINES	P EY S AY N Z
PAIDGE	P EY JH
PALA	P AE L AH
PALATKA	P AH L AE T AH
PALENVILLE	P AH L EH N V AH L
PALMERSVILLE	P AE L M AH R S V AH L
PALMYRA	P AE L M AH R AH
PALOUSE	P AH L AW Z
PALSA	P AE L S AH
PAMPA	P AE M P AH
PAMPLICO	P AE M P L AH K OW
PAMRAPO	P AE M R AH P OW
PANASOFFKEE	P AE N AH S AH F IY IY
PANERAS	P AE N IH R AH Z
PANGUITCH	P AE N G W AH CH
PANSEY	P AE N Z IY
PANTEGO	P AE N T IY G OW
PAOLA	P EY AH L AH
PAONIA	P EY OW N Y AH
PAPAALOA	P AH P AA L OW AH
PAPAIKOU	P AH P EY K UW
PARAGONAH	P AH R AE G AH N AH
PARAGOULD	P AE R AH G OW L D
PARDEEVILLE	P AA R D IY V AH L
PARDUN	P AA R D AH N
PARISHVILLE	P AH R IH SH V AH L
PARKCHESTER	P AA R K CH EH S T ER
PARKD	P AA R K D
PARKDALE	P AA R K D EY L
PARKERSBUR	P AA R K AH R S B AH R
PARKESBURG	P AA R K EH Z AH R G
PARKSLEY	P AA R K S L IY
PARKSTON	P AA R K S T AH N
PARKSVILLE	P AA R K S V AH L
PARKTON	P AA R K T AH N
PARKVIEW	P AA R K V Y UW
PARKVILLE	P AA R K V AH L
PARKWOOD	P AA R K W UH D
PARMALEE	P AA R M EY L IY
PARON	P AA R AO N
PAROWAN	P AE R OW AH N
PARROTTSVILLE	P AE R AA T S V AH L
PARSONSBURG	P AA R S AA N S B AH R G
PASCACK	P AE S AH K
PASCOAG	P AE S OW G
PASSADUMKEAG	P AE S AE D AH M K IY G
PASTURA	P AE S T Y AH R AH
PATAPSCO	P AH T AE P S OW
PATASKALA	P AH T AE S AH L AH
PATCHOGUE	P AE CH AH G
PATCONG	P AE T AH NG
PATEROS	P EY T ER AA S
PATHFORK	P AE TH F AO R K
PATOKA	P AE T AH K AH
PATSEY	P AE T S IY
PATTENBURG	P AE T EH N B AH R G
PATTERSONVILLE	P AE T AH R S AA N V AH L
PATTONSBURG	P AE T AA N S B AH R G
PATTONVILLE	P AE T AA N V AH L
PAULDEN	P AO L D AH N
PAULIS	P EY AH L AH S
PAULISON	P AO L AH S AH N
PAULLINA	P AO L AH N AH
PAULSBORO	P AO L S B AH R OW
PAUMA	P AO M AH
PAUPACK	P AO P AH K
PAUW	P AO W
PAV	P AE V
PAVONIA	P AH V OW N Y AH
PAWCATUCK	P AO K AH T AH K
PAWHUSKA	P AH HH AH S AH
PAWLET	P AO L AH T
PAWLEYS	P AH L EY Z
PAXICO	P AE K S AH K OW
PAXINOS	P AA K S IH N AA S
PAXVILLE	P AE K S V AH L
PAYNES	P EY N Z
PAYNESVILLE	P EY N EH Z AH L
PAYNEVILLE	P EY N AH V AH L
PAYNEWAY	P EY N Y UW EY IY
PE	P IY
PEACHAM	P IY CH AH M
PEACHLAND	P IY CH L AE N D
PEARE	P IY R
PEARISBURG	P IY R IH Z AH R G
PEARLAND	P AE ER L AE N D
PEARSONVILLE	P AH R S AA N V AH L
PEARTREE	P AE ER T R IY
PECATONICA	P EH K AH T AA N AH K AH
PECKS	P EH K S
PECKVILLE	P EH K V AH L
PECONIC	P EH K AH N AH K
PECOS	P EH K AH Z
PEDRICKTOWN	P EH D R AH K T OW N
PEEKSKILL	P IY K S K IH L
PEEVER	P IY V AH R
PEHLE	P EH L
PEJEPSCOT	P AH JH EH P S AH T
PEKOLA	P EH K AH L AH
PELAHATCHIE	P AH L AE HH AH CH AY
PELION	P IY L IY AH N
PELKIE	P EH L K AY
PELSOR	P EH L S AH R
PEMAQUID	P AH M AE K W AH D
PEMBERVILLE	P EH M B AH R V AH L
PEMBINE	P EH M B AY N
PEMBROOK	P EH M B R AH K
PENALOSA	P AH N AE L AH S AH
PENASCO	P AH N AE S OW
PENBROKE	P EH N B R OW K
PENBROOK	P EH N B R UH K
PENCER	P EH N S AH R
PENDALE	P EH N D EY L
PENDROY	P EH N D R OW IY
PENGILLY	P EH N G IH L IY
PENHOOK	P EH N HH UH K
PENLLYN	P EH N L AH N
PENNCO	P EH N NG K OW
PENNDEL	P EH N D AH L
PENNELLVILLE	P EH N EH L V AH L
PENNGROVE	P EH N G R OW V
PENNROAD	P EH N R OW D
PENNSBURG	P EH N S B AH R G
PENNSVILLE	P EH N S V AH L
PENNVILLE	P EH N V AH L
PENNYFIELD	P EH N IY F IY L D
PENOKEE	P EH N AH K IY IY
PENRYN	P EH N R AH N
PENTWATER	P EH N T W EY T AH R
PEOA	P IY OW AH
PEOSTA	P IY AA S T AH
PEOTONE	P IY AH T OW N
PEPEEKEO	P IY P IY K IY OW
PEQUANNOCK	P EH K W AA N AH K
PEQUEA	P EH K W IY AH
PEQUOT	P EH K W AH T
PERDIDO	P AH R D IH D OW
PERI	P AH R IY
PERINA	P AH R AH N AA
PERKASIE	P AH R K EY S AY
PERKINSTON	P ER K IH N Z T AH N
PERKINSVILLE	P AH R K IH N S V AH L
PERKINTOWN	P ER K IH N T AW N
PERKIOMEN	P AH R K AY AH M AH N
PERKIOMENVILLE	P AH R K AY AH M EH N V AH L
PERLITA	P AH R L IH T AH
PEROTE	P AH R OW T
PERRINEVILLE	P AH R IH N AH V AH L
PERRINTON	P AH R IH N T AH N
PERRIS	P EH R IY Z
PERRONVILLE	P AH R AA N V AH L
PERRYSBURG	P AH R IH Z AH R G
PERRYSVILLE	P AH R IH Z AH L
PERRYTON	P EH R IY T AH N
PERRYTOWN	P EH R IY T AW N
PERRYVILLE	P AH R IH V AH L
PERSONETTE	P ER S AH N EH T
PERTERSONS	P ER T ER S AH N Z
PESCADERO	P EH S AE D AH R OW
PESHASTIN	P AH SH AE S T AH N
PESHINE	P AH SH AY N
PESHTIGO	P EH SH T AH G OW
PESOTUM	P EH S AH T AH M
PETERSHAM	P IY T ER SH AE M
PETERSONS	P IY T ER S AH N Z
PETERSTOWN	P IY T ER Z T AW N
PETTIBONE	P EH T AH B OW N
PEVELY	P IY V L IY
PEWAMO	P Y UW AH M OW
PEWAUKEE	P Y UW AH K IY IY
PEWEE	P Y UW IY
PEYSTER	P EY S T AH R
PEYTONA	P EY T AH N AH
PEYTONSBURG	P EY T AA N S B AH R G
PFAFFTOWN	F AE F T OW N
PFLUGERVILLE	F L UW JH AH R V AH L
PHEBA	F EH B AH
PHILIPSBURG	F AH L IH P S B AH R G
PHILIPSE	F IH L AH P S
PHILLIPSBURG	F IH L IH P S B AH R G
PHILOMATH	F IH L AH M AH TH
PHIPPSBURG	F IH P S B AH R G
PHL.	P IY EY CH EH L
PHLOX	F L AA K S
PHOENIXVILLE	F OW AH N IH K S V AH L
PHONETON	F OW N T AH N
PHROANE	F R OW N
PIASA	P AY AH S AH
PIAVE	P AY AH V
PICACHO	P IH K AH CH OW
PICKAWAY	P IH K AH W EY
PICKERINGTON	P IH K ER IH NG T AH N
PICKERSGILL	P IH K ER Z G IH L
PICKTON	P IH K T AH N
PIERCEFIELD	P IH ER S F IY L D
PIERCETON	P IH ER S T AH N
PIERCEVILLE	P IY R S AH V AH L
PIERMONT	P IY R M AH N T
PIERZ	P IY R Z
PIKESVILLE	P AH K EH Z AH L
PIKEVILLE	P IH K AH V AH L
PIMENTO	P AH M EH N T OW
PIMMIT	P IH M AH T
PINCHOT	P IH NG K AH T
PINCKNEYVILLE	P IH NG K N EY V AH L
PINCONNING	P IH N K AA N IH NG
PINDALL	P IH N D AH L
PINEBLUFF	P AY N B L AH F
PINEBROOK	P AY N B R UH K
PINECLIFFE	P AH N EH K L AH F
PINECLUSTER	P AY N K L AH S T ER
PINECREST	P AY N K R EH S T
PINEDALE	P AY N D EY L
PINEGROVE	P AY N G R OW V
PINEHURST	P IH N AH HH AH R S T
PINELAND	P AY N L AE N D
PINELAWN	P AY N L AO N
PINETOP	P AY N T AA P
PINETOPS	P AY N T AA P S
PINETOWN	P AY N T AW N
PINEVIEW	P AY N V Y UW
PINEVILLE	P IH N AH V AH L
PINEWOOD	P AY N W UH D
PINEY	P AY N IY
PINOLE	P AH N OW L
PINON	P IH N AO N
PINOPOLIS	P AH N AA P AH L AH S
PINSONFORK	P IH N S AH N F AO R K
PINTURA	P IH N T Y AH R AH
PIOCHE	P AY AH CH
PIPERSVILLE	P AH P AH R S V AH L
PIPESTEM	P AY P S T EH M
PIQUA	P IH K W AH
PIRE	P AY R
PISECO	P IH S AH K OW
PISEK	P IH S AH K
PISGAH	P IH Z AH
PISINEMO	P AH S IH N AH M OW
PITCAIRN	P IH T K AE ER N
PITTSTOWN	P IH T S T OW N
PITTSVIEW	P IH T S V IY W
PITTSVILLE	P IH T S V AH L
PKWY.	K W AY
PKY	K AY
PL.	P IY EH L
PLACERVILLE	P L AH S AH R V AH L
PLACITAS	P L AE S AH T AH Z
PLAINE	P L EY N
PLAINSBORO	P L EY N S B AH R OW
PLAINVILLE	P L EY N V AH L
PLAINWELL	P L EY N W EH L
PLAISTOW	P L EY Z T OW
PLANDOME	P L AE N D OW M
PLANKINTON	P L AE N K IH N T AH N
PLANTEN	P L AE N T AH N
PLANTERSVILLE	P L AE N T AH R S V AH L
PLANTSVILLE	P L AE N T S V AH L
PLAQUEMINE	P L AE K M AY N
PLATTEVILLE	P L AE T AH V AH L
PLATTSBURG	P L AE T S B AH R G
PLATTSMOUTH	P L AE T S M AW TH
PLATTWOOD	P L AE T W UW D
PLAUCHEVILLE	P L AO CH AH V AH L
PLAUDERVILLE	P L AH D AH R V AH L
PLCE	P L S
PLEASANTVIEW	P L EH Z AH N T V Y UW
PLENTYWOOD	P L EH N T IY W UH D
PLEVNA	P L EH V N AH
PLNS	P IY EH L EH N S
PLOUGHMANS	P L AW M AH N Z
PLUMERVILLE	P L UW M AH R V AH L
PLUMTREE	P L AH M T R IY
POCASSET	P AH K AE S AH T
POCOLA	P AA K AH L AH
POCOMOKE	P AA K AH M OW K
POESTENKILL	P OW AH S T EH NG K AH L
POHATCONG	P AH HH AE T AH NG
POI	P OY
POILLON	P OY L AH N
POINCIANA	P OY N S IY AH N AH
POINIER	P OY N AY AH R
POINTBLANK	P OY N T B L AE NG K
POINTVILLE	P OY N T V AH L
POJOAQUE	P AH JH OW K
POLACCA	P AH L AE K AH
POLEBRIDGE	P OW L B R IH JH
POLHEMAS	P OW L HH AH M AH Z
POLIFLY	P AH L IH F L IY
POLKTON	P OW L K T AH N
POLLOCKSVILLE	P AA L AA K S V AH L
POLVADERA	P OW L V AE D AH R AH
POMANDER	P AH M AE N D AH R
POMARIA	P AH M AE R IY AH
POMEROYTON	P AA M AH R OY T AH N
POMFRET	P AA M F R AH T
POMPEII	P AA M P IY IY
POMPESSE	P AA M P AH S
POMPEYS	P AA M P EY Z
POMPTON	P AA M P T AH N
PONCA	P AO NG K AH
PONCHATOULA	P AO NG K AH T AW L AH
PONDVIEW	P AA N D V Y UW
PONEMAH	P AA N AH M AH
PONETO	P AA N AH T OW
PONSFORD	P AA N S AH R D
PONTOOSUC	P AA N T UW S AH K
PONTOTOC	P AA N T AH T AH K
POOLES	P UW L Z
POOLESVILLE	P UW L EH Z AH L
POOLVILLE	P UW L V AH L
POPAKE	P AH P EY K
POPLARVILLE	P AA P L AA R V AH L
POPLE	P OW P AH L
POPPENHUSEN	P AA P EH N AH S AH N
POQUOSON	P AA K W AH S AH N
PORTAGEVILLE	P AO R T AE JH AH V AH L
PORTERSVILLE	P AO R T AH R S V AH L
PORTERVILLE	P AO R T AH R V AH L
PORTHILL	P OW R T HH IH L
PORTLA	P AO R T L AH
PORTLANDVILLE	P AO R T L AE N D AH L
PORTOLA	P AO R T AH L AH
PORTVILLE	P AO R T V AH L
PORUM	P AO R AH M
POSEYVILLE	P OW S EY V AH L
POSTELLE	P AA S T AH L
POSTVILLE	P AA S T V AH L
POTEAU	P OW T IY UW
POTOSI	P AA T AH S IY
POTRERO	P AA T R AH R OW
POTTERSDALE	P OW T ER Z D EY L
POTTERSVILLE	P AA T AH R S V AH L
POTTERVILLE	P AA T AH R V AH L
POTTSBORO	P AA T S B AH R OW
POTTSVILLE	P AA T S V AH L
POTWIN	P AA T W IH N
POUGHQUAG	P AW K W AH G
POULAN	P OW AH L AH N
POULSBO	P OW L S B OW
POULTNEY	P OW L T N IY
POWAY	P OW EY IY
POWDERHORN	P AW D ER HH AO R N
POWDERVILLE	P OW D AH R V AH L
POWELLS	P OW AH L Z
POWELLTON	P OW EH L T AH N
POWELTON	P OW EH L T AH N
POWERSITE	P AW ER S AY T
POWERSVILLE	P OW AH R S V AH L
POWHATAN	P OW EY T AH N
POWHATTAN	P OW HH AE T AH N
POWNAL	P OW N AH L
POY	P OW IY
POYEN	P OY AH N
POYNETTE	P OY N EH T
PRATTS	P R AE T S
PRATTSBURG	P R AE T S B AH R G
PRATTSVILLE	P R AE T S V AH L
PREMONT	P R IY M AA N T
PRESHO	P R IY SH OW
PRESQUE	P R IY S IY
PRESTWICK	P R IY S T W IH K
PRIMGHAR	P R IH M AH R
PRIMOS	P R IH M AA S
PRINCEWOOD	P R IH N S W UH D
PRINEVILLE	P R IH N AH V AH L
PRINSBURG	P R IH N S B AH R G
PROCTORSVILLE	P R OW K T AO R S V AH L
PROCTORVILLE	P R OW K T AO R V AH L
PROL	P R AA L
PROLE	P R OW L IY
PROMPTON	P R AA M P T AO N
PROPHETSTOWN	P R AA F AH T S T AW N
PROTEM	P R OW T EH M
PROVENCAL	P R UW V AH N S AH L
PRUDENVILLE	P R UW D EH N V AH L
PRYSE	P R AY Z
PSYC	S IH K
PT	P IY T
PUKWANA	P AH K W AH N AH
PULGA	P UH L G AH
PULTENEY	P UH L T IY N IY
PUMONE	P Y UW M OW N
PUNCHEON	P AH N CH AH N
PUNXSUTAWNEY	P AH NG K S AH T AW N IY
PUPOSKY	P Y UW P AA S IY
PURDYS	P AH R D AH Z
PURGITSVILLE	P AH R JH IH T S V AH L
PURLEAR	P ER L IH ER
PURLING	P ER L IH NG
PURMELA	P AH R M AH L AH
PURROY	P AH R OW IY
PURSGLOVE	P AH R S G L OW V
PUXICO	P AH K S AH K OW
PUYALLUP	P Y UW AY AE L AH P
PYLESVILLE	P AH L EH Z AH L
PYOTE	P AY OW T
PYRMID	P AH R M AH D
QUAKAKE	K W AH K EY K
QUAKERBRIDGE	K W EY K ER B R IH JH
QUAKERTOWN	K W EY K ER T AW N
QUAMBA	K W AA M B AH
QUANAH	K W AA N AH
QUAPAW	K W AA P AH
QUARRYVILLE	K W AO R AH V AH L
QUASQUETON	K W AA S W AH T AH N
QUEBECK	K W EH B AH K
QUEENEY	K W IY N IY
QUEENSBORO	K W IY N S B AH R OW
QUEENSBRIDGE	K W IY N Z B R IH JH
QUEENSBURY	K W IY N Z B EH R IY
QUEENSDALE	K W IY N Z D EY L
QUEENSTON	K W IY N Z T AH N
QUEENSTOWN	K W IY N Z T AW N
QUEMADO	K W EH M AH D OW
QUENCER	K W EH N S AH R
QUENEMO	K W EH N AH M OW
QUESTA	K W EH S T AH
QUILCENE	K W IH L S IY N
QUINAULT	K W IH N AH L T
QUINEBAUG	K W IH N AH B AH G
QUINHAGAK	K W IH N HH AH G AH K
QUINNESEC	K W IH N AH S AH K
QUINTARD	K W IH N T AH R D
QUITAQUE	K W IH T AH K
QUITMAN	K W IH T M AE N
QUIVIRA	K W IH V AH R AH
QULIN	K W L IH N
QUOGUE	K W AA G
QUOIN	K W OY N
RACELAND	R EY S L AE N D
RACKERBY	R AE K ER B AY
RACO	R AE K OW
RADERSBURG	R AH D AH R S B AH R G
RADIGAN	R AE D AH G AH N
RADIX	R AE D AH K S
RAEFORD	R IY F AH R D
RAGAZZI	R AH G AE Z IY
RAGLEY	R AE G L IY
RAILSTATION	R EY L S T EY SH AH N
RAILY	R EY L IY
RAINELLE	R EY N AH L
RAINSVILLE	R EY N S V AH L
RAINTREE	R EY N T R IY
RAMAH	R AE M AH
RAMAPO	R AE M AH P OW
RAMBLEWOOD	R AE M B AH L W UH D
RAMOPO	R AE M AH P OW
RAMPART	R AE M P AA R T
RANBURNE	R AE N B AH R N
RANC	R AE NG K
RANCHESTER	R AE N CH AH S T ER
RANCHITA	R AE NG K AH T AH
RANCHOS	R AE N CH OW Z
RANCHWOOD	R AE N CH W UH D
RANCOCAS	R AE NG K AH K AH Z
RANDALIA	R AE N D EY L Y AH
RANDALLS	R AE N D AH L Z
RANDALLSTOWN	R AE N D AH L S T OW N
RANDSBURG	R AE N D S B AH R G
RANGELEY	R AE N JH IY L IY
RANGELY	R EY N JH L IY
RANIER	R AE N IY ER
RANOLDO	R AH N OW L D OW
RANSHAW	R AE N SH AO
RANSOMVILLE	R AE N S AA M V AH L
RAPELJE	R AE P AH L JH
RAPELYE	R EY P L AY
RAPHINE	R AH F AY N
RAPIDAN	R AE P AH D AH N
RAQUETTE	R AE K W EH T
RARDEN	R AA R D AH N
RATBURN	R AE T B ER N
RATHDRUM	R AE TH D R AH M
RATZER	R AE T S AH R
RAVENA	R AE V AH N AH
RAVENCLIFF	R EY V AH N K L IH F
RAVENDALE	R EY V AH N D EY L
RAVENDEN	R EY V AH N D EH N
RAVENHURST	R AH V EH N HH AH R S T
RAVENSDALE	R EY V AH N Z D EY L
RAVENWOOD	R EY V AH N W UH D
RAVINIA	R AH V IH N Y AH
RAYLAND	R EY L AE N D
RAYMONDS	R EY M AH N D Z
RAYMONDVILLE	R EY M AA N D AH L
RAYMORE	R EY M AH R
RAYNESFORD	R EY N EH S AH R D
RAYNHAM	R EY N HH AH M
RAYSVILLE	R EY Z AH L
RAYTOWN	R EY T AW N
RAYVILLE	R EY V AH L
RAYWICK	R EY W IH K
RDG	AA R D IY G
RDS	AA R D IY S
READFIELD	R IY D F IY L D
READLYN	R IY AE D L AH N
READSBORO	R IY AE D S B AH R OW
READSTOWN	R IY D Z T AW N
READYVILLE	R IY AE D AH V AH L
REALITOS	R IY AH L IH T AA S
REARDAN	R IY AA R D AH N
REASNOR	R IY AE Z N AH R
REBERSBURG	R IH B AH R S B AH R G
REBOOT	R IY B UW T
REDBY	R EH D B AY
REDCREST	R EH D K R EH S T
REDFOX	R EH D F AA K S
REDGRANITE	R EH D G R AE N AH T
REDKEY	R EH D K IY
REDLAKE	R EH D L EY K
REDLANDS	R EH D L AE N D Z
REDOWL	R EH D AW L
REDVALE	R EH D V EY L
REDWAY	R EH D W EY
REEDLEY	R IY EH D L IY
REEDPOINT	R IY D P OY N T
REEDSBURG	R IY EH D S B AH R G
REEDSVILLE	R IY EH D S V AH L
REEDVILLE	R IY EH D AH L
REEDYVILLE	R IY EH D AH V AH L
REELSVILLE	R IY EH L S V AH L
REESEVILLE	R IY EH S AH V AH L
REEVESVILLE	R IY AH V EH Z AH L
REGI	R AH JH IY
REHILL	R IY HH IH L
REHOBOTH	R IY HH OW B OW TH
REIDSVILLE	R IY IH D S V AH L
REINBECK	R IY IH N B EH K
REINHOLDS	R IY IH N HH OW L D Z
REISTERSTOWN	R IY IH S T AH R S T OW N
REKLAW	R IH K L AO
RELLIM	R IH L IH M
REMINDERVILLE	R AH M IH N D AH R V AH L
REMLAP	R IH M L AE P
REMLIK	R IH M L IH K
RENOVO	R AH N OW V OW
RENSSELAERVILLE	R IH N S AH L IY R V AH L
RENVILLE	R IH N V IH L
REON	R IY AO N
REPAUNO	R AH P AO N OW
REPAUPO	R AH P AO P OW
REPTON	R EH P T AH N
RETFORD	R IH T AO R D
RETNER	R EH T N AH R
REUBENS	R IY Y UW B AH N Z
REV.	R EH V
REVELO	R AH V EH L OW
REWE	R AH W IY
REXBURG	R IH Z AH R G
REXVILLE	R IH Z IH L
REYDELL	R IY Y D EH L
REYDON	R IY Y D AA N
REYNOLDSBURG	R IY Y N OW L D S B AH R G
REYNOLDSVILLE	R IY Y N OW L D S V AH L
RHINEBECK	R AY N B EH K
RHINELANDER	R AY N L AE N D ER
RHOADESVILLE	R OW D EH Z AH L
RHODELIA	R AH D IY L Y AH
RHODESDALE	R OW D Z D EY L
RIALTO	R AY AE L T OW
RICEBORO	R AH S EH B AH R OW
RICES	R AY S IH Z
RICETOWN	R AY S T AW N
RICHARDSVILLE	R AH CH AA R D S V AH L
RICHARDTON	R IH CH AA R D T AH N
RICHBORO	R IH CH B AH R OW
RICHLANDS	R IH CH L AE N D Z
RICHLANDTOWN	R IH CH L AE N D T AW N
RICHMONDVILLE	R IH CH M AA N D AH L
RICHVIEW	R IH CH V Y UW
RICHVILLE	R IH CH V AH L
RICHWOOD	R IH CH W UH D
RICHWOODS	R IH CH W UH D Z
RICKREALL	R IH K R AH L
RIDDLETON	R IH D AH L T AH N
RIDGEDALE	R IH JH D EY L
RIDGELAND	R IH JH L AE N D
RIDGEVIEW	R IH JH V Y UW
RIDGEVILLE	R IH JH AH V AH L
RIDOTT	R IH D AH T
RIEGELMAN	R IY JH EH L M AH N
RIEGELSVILLE	R IY JH EH L S V AH L
RIEGELWOOD	R IY JH AH L W UW D
RIENZI	R IY N Z IY
RIESEL	R IY S AH L
RIGIMAR	R IH JH AH M AH R
RILEYVILLE	R AH L EY V AH L
RILLO	R IH L OW
RILLTON	R IH L T AH N
RIMINI	R IH M AH N IY
RIMROCK	R IH M R AA K
RINDGE	R IH N JH
RINEYVILLE	R AH N EY V AH L
RINGOES	R IH N G OW Z
RINGSTED	R IH NG Z T EH D
RINGTOWN	R IH NG T AW N
RIOMEDINA	R AY AH M EH D AH N AH
RIPER	R AY P ER
RIPON	R IH P AO N
RIPPLEMEAD	R IH P AH L M IY D
RIPTON	R IH P T AH N
RIRIE	R IH R AY
RISINGSUN	R AY Z IH NG S AH N
RISOLI	R IH S AH L IY
RITO	R IH T OW
RITZVILLE	R IH T S V AH L
RIV	R IH V
RIVE	R AY V
RIVERCREST	R IH V ER K R EH S T
RIVEREDGE	R IH V ER EH JH
RIVERTON	R IH V ER T AH N
RIVERVIEW	R IH V ER V Y UW
RIVERWALK	R IH V ER W AO K
RIVESVILLE	R AH V EH Z AH L
RIVINGTON	R AH V IH N G T AH N
RIXEYVILLE	R IH K S EY V AH L
RIXFORD	R IH K S AH R D
ROACHDALE	R OW CH D EY L
ROANN	R OW N
ROBARD	R AA B AH R D
ROBBINSDALE	R AA B IH N Z D EY L
ROBBINSTON	R AA B IH N Z T AH N
ROBBINSVILLE	R AA B IH N S V AH L
ROBELINE	R OW B L AY N
ROBERSONVILLE	R AA B AH R S AA N V AH L
ROBERTSBURG	R AH B AH R T S B AH R G
ROBERTSDALE	R AA B ER T S D EY L
ROBERTSVILLE	R AH B AH R T S V AH L
ROBESONIA	R AA B AH S OW N Y AH
ROBINSONVILLE	R AA B AH N S AA N V AH L
ROBITZEK	R AH B IH T S AH K
ROBSTOWN	R AA B Z T AW N
ROCHAMBEAU	R AH CH AE M B IY UW
ROCHDALE	R AA CH D EY L
ROCHEPORT	R AA CH AH P AH R T
ROCHERT	R AA CH AH R T
ROCIADA	R OW S IY AH D AH
ROCKAWAYS	R AA K AH W EY Z
ROCKBRIDGE	R AA K B R IH JH
ROCKDALE	R AA K D EY L
ROCKERVILLE	R AA K AH R V AH L
ROCKFALL	R AA K F AO L
ROCKFISH	R AA K F IH SH
ROCKHAM	R AA K HH AE M
ROCKHOLDS	R AA K HH OW L D Z
ROCKLAKE	R AA K L EY K
ROCKLEDGE	R AA K L EH JH
ROCKLEIGH	R AA K L EY
ROCKMART	R AA K M AA R T
ROCKSPRINGS	R AA K S P R IH NG Z
ROCKTON	R AA K T AH N
ROCKVALE	R AA K V EY L
ROCKWAY	R AA K W EY
ROCKYBRANCH	R AA K IY B R AE N CH
RODESSA	R AH D EH S AH
ROERICH	R OW R IH CH
ROESSLEVILLE	R OW EH S L AH V AH L
ROGERSVILLE	R AH JH AH R S V AH L
ROGGEN	R AA G AH N
ROHNERT	R AA N AH R T
ROHRERSTOWN	R AA R AH R S T OW N
ROHRERSVILLE	R AH R AH R S V AH L
ROKEBY	R AA K AH B IY
ROLESVILLE	R AH L EH Z AH L
ROLLAG	R AA L AH G
ROLLINGSTONE	R OW L IH NG S T OW N
ROLLINSFORD	R OW L IH N Z F OW R D
ROLLINSVILLE	R AA L IH N S V AH L
ROMAR	R OW M AH R
ROMBOUTS	R AA M B AH Y UW T S
ROMEOVILLE	R OW M IY AH V AH L
ROMOLAND	R AA M AH L AH N D
RONCEVERTE	R AA N S AH V AH R T
RONDE	R AA N D
RONKONKOMA	R AO NG K AO NG K AH M AH
RONKS	R AO NG K S
ROODHOUSE	R UW D HH AW Z
ROOPVILLE	R UW P V AH L
ROOTSTOWN	R UW T S T AW N
ROPESVILLE	R AH P EH Z AH L
ROSANKY	R AH S AE NG K IY
ROSBURG	R AA Z AH R G
ROSCOMMON	R AA S AA M AH N
ROSDALE	R AA Z D EY L
ROSEBANK	R OW Z B AE NG K
ROSEBURG	R AA S AH B AH R G
ROSECLIFF	R OW Z K L IH F
ROSEDALE	R OW Z D EY L
ROSEGATE	R OW Z G EY T
ROSEGLEN	R OW Z G L EH N
ROSEHILL	R OW Z HH IH L
ROSELD	R AA S AH L D
ROSELLE	R AA S AH L
ROSEMOUNT	R OW Z M AW N T
ROSENHAYN	R AA S AH N HH EY N
ROSETO	R AA S AH T OW
ROSHARON	R AA SH AH R AH N
ROSHOLT	R AH SH OW L T
ROSICLARE	R AH S IH K L AH R
ROSLINDALE	R AA Z L AH N D EY L
ROSSBURG	R AA S B AH R G
ROSSFORD	R AA S AH R D
ROSSMOOR	R AA S M OW AH R
ROSSTON	R AA S T AH N
ROSSVILLE	R AA S V AH L
ROSTRAVER	R AA S T R EY V AH R
ROSZEL	R AA Z AH L
ROTHBURY	R AA TH B Y AH R IY
ROTHSAY	R AA TH S EY IY
ROTHVILLE	R AA TH V AH L
ROUGEMONT	R AW JH AH M AH N T
ROUGON	R AW G AH N
ROUNDHILL	R AW N D HH IH L
ROUSES	R AW Z IH Z
ROWAYTON	R OW EY T AH N
ROWESVILLE	R OW EH Z AH L
ROXBORO	R AA K S B AH R OW
ROXOBEL	R AA K S AH B AH L
ROXTON	R AA K S T AH N
ROYALTON	R OY AH L T AH N
ROZEL	R AA Z AH L
ROZET	R AA Z AH T
RR	AA R
RT	AA R T
RT.	AA R T IY
RUBIDOUX	R UW B AH D AW K S
RUDDEROW	R AH D AH R OW
RUDDERROW	R AH D ER R OW
RUES	R UW Z
RUFFS	R AH F S
RUGGIERIO	R AH JH IY R IY OW
RUIDOSO	R UW D AH S OW
RULEVILLE	R UW L AH V AH L
RULO	R UW L OW
RUMANA	R UW M AH N AH
RUMBA	R AH M B AH
RUMELY	R UW M L IY
RUMPLER	R AH M P AH L ER
RUNA	R UW N AH
RUNNEMEDE	R AH N AH M IY D
RUNNYMEDE	R AH N AH M IY D
RUSCOE	R AH S OW
RUSHSYLVANIA	R AH SH S AH L V EY N Y AH
RUSHVILLE	R AH SH V AH L
RUSO	R UW S OW
RUSSEK	R AH S AH K
RUSSELLS	R AH S AH L Z
RUSSELLTON	R AH S EH L T AH N
RUSSELVILLE	R AH S EH L V AH L
RUSSIAVILLE	R AH S IY AH V AH L
RUSSLYN	R AH S L AH N
RUSTBURG	R AH S T B AH R G
RUTHERFORDTON	R UW TH ER F OW R D T AH N
RUTHERON	R AH T HH EH R AH N
RUXTON	R AH K S T AH N
RUYTER	R UW W AY T AH R
RVR	AA R V IY R
RWDY	R W D AY
RWJU	R W JH UW
RY	R AY
RYAWA	R AY AH AH
RYDAL	R AY D AH L
RYDERS	R IH D AH R Z
RYDERWOOD	R IH D AH R W UW D
RYEGATE	R AY G EY T
S.B.	EH S B IY
S.CONDUIT	EH S K AA N D UW AH T
SABATTUS	S AH B AE T AH S
SABETHA	S AE B AH TH AH
SABILLASVILLE	S AE B AH L AE Z AH L
SABINAL	S AE B AH N AH L
SABINSVILLE	S AH B IH N S V AH L
SABOT	S AE B AH T
SABULA	S AE B Y UW L AH
SACATON	S AE K AH T AH N
SACCHERI	S AE K AH R IY
SACKETS	S AE K AH T S
SADDLEBROOK	S AE D AH L B R UH K
SADE	S EY D
SADIEVILLE	S EY D IY V AH L
SADORUS	S AE D AH R AH S
SAEGERTOWN	S IY JH AH R T OW N
SAFFAN	S AE F AH N
SAGAMORE	S AE G AH M AH R
SAGERTON	S EY JH ER T AH N
SAGLE	S EY G AH L
SAGOLA	S AE G AH L AH
SAGUACHE	S AE G W AH CH
SAHUARITA	S AE HH Y UW AE R AH T AH
SAINTE	S EY N T
SALADO	S AE L AH D OW
SALAMONIA	S AE L AH M OW N Y AH
SALCHA	S AE L CH AH
SALDEE	S AE L D IY IY
SALEMBURG	S AH L EH M B AH R G
SALESVILLE	S AH L EH Z AH L
SALIDA	S AE L AH D AH
SALINEVILLE	S AH L IH N AH V AH L
SALITPA	S AH L IH T AH
SALIX	S AE L AH K S
SALKUM	S AE L K AH M
SALLADASBURG	S AE L AH D AE Z AH R G
SALLISAW	S AE L AH S AH
SALOL	S AE L AH L
SALTAIRE	S AO L T AH AY ER
SALTILLO	S AE L T IH L OW
SALTSBURG	S AE L T S B AH R G
SALTVILLE	S AE L T V AH L
SALUDA	S AH L UW D AH
SALUNGA	S AH L AH N G AH
SAMMLER	S AE M L AH R
SAMPTON	S AE M P T AH N
SANATOGA	S AH N AE T AH G AH
SANBORNTON	S AE N B AO R N T AH N
SANBORNVILLE	S AE N B AO R N V AH L
SANDALWOOD	S AE N D AH L W UH D
SANDBORN	S AE N D B AO R N
SANDESTIN	S AE N D AH S T IH N
SANDGAP	S AE N D G AE P
SANDISFIELD	S AE N D IY Z F IY L D
SANDOWN	S AE N D OW N
SANDSTON	S AE N D Z T AH N
SANDYVILLE	S AE N D AH V AH L
SANDYWOOD	S AE N D IY W UH D
SANGERVILLE	S AE N JH AH R V AH L
SANHICAN	S AH N IH S AH N
SANIBEL	S AE N AH B AH L
SANILAC	S AE N AH L AH K
SANITARIA	S AE N AH T AE R IY AH
SANTEE	S AE N T IY IY
SAPELLO	S AH P EH L OW
SAPELO	S AE P AH L OW
SAPULPA	S AH P UH L P AH
SARAHSVILLE	S AH R AE S V AH L
SARALAND	S AE R AH L AH N D
SARANAC	S AE R AH N AH K
SARCONA	S AA R K AH N AH
SARCOXIE	S AA R K AA K S AY
SARDIS	S AA R D AH S
SAREPTA	S AH R EH P T AH
SARGENTVILLE	S AA R JH EH N T V AH L
SARITA	S AE R AH T AH
SARONA	S AE R AH N AH
SARONVILLE	S AH R AA N V AH L
SARPY	S AA R P IY
SARTELL	S AA R T AH L
SASAKWA	S AH S AE K W AH
SATANTA	S AE T AE N T AH
SATARTIA	S AH T AA R SH IY AH
SATSUMA	S AE T S UW M AH
SAUGATUCK	S AO G AH T AH K
SAUGET	S AO JH AH T
SAUGUS	S AO G AH S
SAUKVILLE	S AO K V AH L
SAULL	S AO L
SAULSVILLE	S AO L S V AH L
SAULTELL	S AO L T AH L
SAUN	S AO N
SAUNDERSTOWN	S AO N D AH R S T OW N
SAUNEMIN	S AO N AH M AH N
SAUQUOIT	S AO K W OY T
SAUTEE	S AO T EY IY
SAVONBURG	S AH V AA N B AH R G
SAVOONGA	S AH V UW N G AH
SAWOOD	S AO UW D
SAWYERVILLE	S AO AY AH R V AH L
SAXONBURG	S AE K S AA N B AH R G
SAXTONS	S AE K S T AH N Z
SAYLORSBURG	S EY L AO R S B AH R G
SAYNER	S EY N AH R
SAYREVILLE	S EY R AH V AH L
SAYRS	S EY R Z
SAYVILLE	S EY V AH L
SB	EH S B
SC	EH S K
SCALY	S K EY L IY
SCAPPOOSE	S K AE P UW Z
SCARBORO	S K AA R B AH R OW
SCARVILLE	S K AA R V AH L
SCHAGHTICOKE	S K AE T AH K OW K
SCHALKS	S K AE K S
SCHEFFELIN	S K EH F AH L AH N
SCHELLSBURG	S K EH L S B AH R G
SCHENEVUS	S K EH N AH V AH S
SCHERERVILLE	S K AH R AH R V AH L
SCHIBANOFF	S K IH B AH N AH F
SCHMIDTS	S K M IH D T S
SCHNECKSVILLE	S K N EH K S V AH L
SCHNELLVILLE	S K N EH L V AH L
SCHODACK	S K AA D AH K
SCHOENCHEN	S K OW EH N CH AH N
SCHOHARIE	S K AA HH AH R AY
SCHOPMANN	S K AA P M AH N
SCHRAALENBURGH	S K R AH L EH N B AH R
SCHROEDERS	S K R OW AH D AH R Z
SCHROON	S K R UW N
SCHULMEISTER	S K AH L M IY S T AH R
SCHURZ	S K AH R Z
SCHUYLERVILLE	S K Y UW AH L AH R V AH L
SCHWEIKERTS	S K W IY K AH R T S
SCHWENKSVILLE	S K W EH NG K S V AH L
SCIO	S AY OW
SCIOTA	S AY AH T AH
SCITUATE	S IH T Y UW EY T
SCIVER	S AY V AH R
SCOOBA	S K UW B AH
SCOPUS	S K OW P AH S
SCOTCHTOWN	S K AA CH T AW N
SCOTLANDVILLE	S K AA T L AE N D AH L
SCOTRUN	S K AA T R AH N
SCOTTDALE	S K AA T D EY L
SCOTTOWN	S K AA T AW N
SCOTTSBURG	S K AA T S B AH R G
SCOTTSVILLE	S K AA T S V AH L
SCOTTVILLE	S K AA T V AH L
SCREVEN	S K R EH V AH N
SCREVIN	S K R EH V AH N
SCUDDERS	S K AH D ER Z
SCUDDY	S K AH D IY
SEABECK	S IY B EH K
SEABRING	S IY B R IH NG
SEACREST	S IY K R EH S T
SEAFOAM	S IY F OW M
SEAFORTH	S IY F OW R TH
SEAGIRT	S IY JH AH R T
SEAGOVILLE	S IY G AH V AH L
SEALEVEL	S IY L EH V AH L
SEARSBORO	S AH R S B AH R OW
SEARSMONT	S AH R S M AH N T
SEARSPORT	S IH ER S P OW R T
SEASONGOOD	S IY Z AH N G UH D
SEASPRAY	S IY S P R EY
SEATAC	S IY T AH K
SEAVIEW	S IY V Y UW
SEBA	S EH B AH
SEBAGO	S EH B AH G OW
SEBASCO	S AH B AE S OW
SEBEKA	S EH B AH K AH
SEBEWAING	S EH B Y UW EY AH NG
SEBOEIS	S AH B OW AH AH S
SEBOYETA	S AH B OY AH T AH
SECANE	S AH K EY N
SECONDCREEK	S EH K AH N D K R IY K
SECOUR	S EH K AH R
SEDGEWICKVILLE	S EH JH UW IH K V AH L
SEDLEY	S EH D L IY
SEDRO	S EH D R OW
SEEDMAN	S IY D M AE N
SEFFNER	S EH F N AH R
SEGNO	S EH G N OW
SEGUINE	S EH G W AY N
SEIAD	S AY AH D
SEILING	S IY AH L AH NG
SEKIU	S IY K IY UW
SELAH	S EH L AH
SELAWIK	S EH L AH AH K
SELBYVILLE	S EH L B AH V AH L
SELINSGROVE	S EH L AH N S G R OW V
SELLERSVILLE	S EH L AH R S V AH L
SELMAR	S EH L M AH R
SELVIN	S EH L V AH N
SEMORA	S EH M AH R AH
SENATH	S EH N AH TH
SENATOBIA	S EH N AH T OW B IY AH
SENECAVILLE	S AH N EH K AH V AH L
SENOIA	S EH N OY AH
SENTERVILLE	S EH N T AH R V AH L
SEQUATCHIE	S EH K W AH CH AY
SEQUIM	S EH K W AH M
SERRELL	S EH R AH L
SESSER	S EH S AH R
SETAUKET	S EH T AH K AH T
SETTLEMEN	S EH T AH L M EH N
SEVERNA	S AH V AH R N AH
SEVIERVILLE	S IY V IY R V AH L
SEWAL	S OW AH L
SEWANEE	S UW AH N IY IY
SEWAREN	S OW ER AH N
SEWICKLEY	S UW IH K L IY
SEXTONS	S EH K S T AH N Z
SHABBONA	SH AE B AH N AH
SHADEHILL	SH EY D HH IH L
SHADYSIDE	SH EY D IY S AY D
SHAFTER	SH AE F T ER
SHAFTOS	SH AE F T AA S
SHAFTSBURY	SH AE F T S B EH R IY
SHAGELUK	SH AE JH AH L AH K
SHAINA	SH EY N AH
SHAKOPEE	SH AE K AH P IY IY
SHAKTOOLIK	SH AE K T UW L AH K
SHALIMAR	SH AE L AH M AH R
SHALLMAR	SH AE L M AH R
SHALLOTTE	SH AE L AH T
SHALLOWATER	SH AE L OW AH T ER
SHANDAKEN	SH AE N D AH K AH N
SHANDON	SH AE N D AH N
SHANIKO	SH AE N AH K OW
SHAPLEIGH	SH AE P L EY
SHARONVILLE	SH AH R AA N V AH L
SHARPSBURG	SH AA R P S B AH R G
SHARPSVILLE	SH AA R P S V AH L
SHARPTOWN	SH AA R P T AW N
SHARROTT	SH AE R AH T
SHARROTTS	SH AE R AH T S
SHARSWOOD	SH AA R S W UW D
SHATTUC	SH AE T AH K
SHAVANO	SH AE V AH N OW
SHAVERTOWN	SH EY V ER T AW N
SHAWANO	SH AO AH N OW
SHAWBORO	SH AO B AH R OW
SHAWMONT	SH AO M AH N T
SHAWNEETOWN	SH AO N AH T OW N
SHAWSVILLE	SH AO S V AH L
SHEEPSHEAD	SH IY P S HH EH D
SHELBIANA	SH EH L B IY AH N AH
SHELBINA	SH EH L B AH N AH
SHELBURN	SH EH L B AH R N
SHELDRAKE	SH EH L D R EY K
SHELLSBURG	SH EH L S B AH R G
SHELOCTA	SH AH L AA K T AH
SHELTERVIEW	SH EH L T ER V Y UW
SHENANGO	SH AH N AE N G OW
SHEPHERDSTOWN	SH EH P ER D Z T AW N
SHEPHERDSVILLE	SH AH F AH R D S V AH L
SHEPPTON	SH EH P T AH N
SHERADEN	SH EH R AH D AH N
SHERANDO	SH AH R AE N D OW
SHERBORN	SH AH R B AH R N
SHERBROOKE	SH AH R B R AH K
SHERMANS	SH AH R M AH N Z
SHERRILLS	SH EH R AH L Z
SHERRODSVILLE	SH EH R AA D S V AH L
SHERRYSTOWN	SH EH R IY Z T AW N
SHEVCHENKO	SH EH V CH EH NG K OW
SHEYENNE	SH EY AH N
SHICKLEY	SH IH K L IY
SHINGLEHOUSE	SH IH NG G AH L HH AW S
SHINGLETOWN	SH IH NG G AH L T AW N
SHINNSTON	SH IH N S T AH N
SHINROCK	SH IH N R AA K
SHIOCTON	SH AY AA K T AH N
SHIPPENSBURG	SH IH P EH N S B AH R G
SHIPPENVILLE	SH IH P EH N V AH L
SHIPROCK	SH IH P R AA K
SHIPSHEWANA	SH IH P UW AH N AH
SHIRLEYSBURG	SH AH R L EY Z AH R G
SHIRRA	SH AH R AH
SHISHMAREF	SH IH SH M AH R AH F
SHO	SH OW
SHOAL	SH OW L
SHOBONIER	SH AH B AA N AY AH R
SHOEMAKERSVILLE	SH OW AH M AH K AH R S V AH L
SHOHOLA	SH AA HH AH L AH
SHOKAN	SH OW K AH N
SHONGALOO	SH AA N G AH L UW
SHONTO	SH AA N T OW
SHOPIERE	SH OW P IY R
SHOPRITE	SH AA P R AY T
SHOPVILLE	SH AA P V AH L
SHOREACRES	SH OW R EY K ER Z
SHOREFRONT	SH OW R F R AH N T
SHOREVIEW	SH OW R V Y UW
SHOREWOOD	SH OW R W UH D
SHORTERVILLE	SH AO R T AH R V AH L
SHORTHILL	SH AO R T HH IH L
SHORTSVILLE	SH AO R T S V AH L
SHOSHONI	SH AA SH AH N IY
SHRADY	SH R EY D IY
SHULERVILLE	SH UW L AH R V AH L
SHULLSBURG	SH AH L S B AH R G
SHUNGNAK	SH AH N G N AH K
SHUNPIKE	SH AH N P AY K
SHUQUALAK	SH AH K W AH L AH K
SHUSHAN	SH AH SH AH N
SHUTESBURY	SH UW T S B EH R IY
SICKLEN	S IH K L AH N
SICKLERVILLE	S IH K L AH R V AH L
SICLEN	S IH K L AH N
SIDEREN	S AY D ER AH N
SIDEVIEW	S AY D V Y UW
SIDWAY	S IH D W EY IY
SIEPER	S IY P AH R
SIERRAVILLE	S IY R AH V AH L
SIKESTON	S AH K EH S T AH N
SILETZ	S IH L AH T S
SILLECK	S IH L AH K
SILOAM	S AH L OW M
SILVERDALE	S IH L V ER D EY L
SILVERHILL	S IH L V ER HH IH L
SILVERPEAK	S IH L V ER P IY K
SILVERSTREET	S IH L V ER S T R IY T
SILVERTON	S IH L V ER T AH N
SILVERWOOD	S IH L V ER W UH D
SIMLA	S IH M L AH
SIMMESPORT	S IH M EH S AH R T
SIMPSONVILLE	S IH M P S AA N V AH L
SIMSBORO	S IH M Z AH R OW
SINCLAIRVILLE	S IH NG K L AH AH R V AH L
SINDEREN	S IH N D AH R AH N
SINDLE	S IH N D AH L
SINKINSON	S IH N K IH N S AH N
SINNAMAHONING	S IH N AE M AH HH OW N AH NG
SINVALCO	S IH N V AE L K OW
SIOU	S AY UW
SIPPI	S IH P IY
SISSONVILLE	S IH S AA N V AH L
SISTERDALE	S IH S T ER D EY L
SISTERSVILLE	S IH S T AH R S V AH L
SKAGWAY	S K AE G W EY IY
SKAMOKAWA	S K AH M AA K AH AH
SKANEATELES	S K EY N AH T IY L Z
SKANEE	S K EY N IY IY
SKELLYTOWN	S K EH L AH T OW N
SKIATOOK	S K IY AH T UH K
SKIPPERVILLE	S K IH P AH R V AH L
SKYKOMISH	S K IH K AH M AH SH
SKYTOP	S K AY T AA P
SKYVIEW	S K AY V Y UW
SLAIGHT	S L EY T
SLANA	S L AE N AH
SLANESVILLE	S L AH N EH Z AH L
SLATERSVILLE	S L AH T AH R S V AH L
SLATERVILLE	S L AH T AH R V AH L
SLATYFORK	S L EY T IY F AO R K
SLAUGHTERDAM	S L AO T ER D AE M
SLE	S AH L
SLEETMUTE	S L IY T M Y UW T
SLICKVILLE	S L IH K V AH L
SLIDELL	S L IH D AH L
SLIGO	S L IH G OW
SLINGERLANDS	S L IH NG ER L AE N D Z
SLOANS	S L OW N Z
SLOANSVILLE	S L OW N S V AH L
SLOATSBURG	S L OW T S B AH R G
SLOSSON	S L AA S AH N
SLOVAN	S L OW V AH N
SMACKOVER	S M AE K OW V ER
SMARTVILLE	S M AA R T V AH L
SMELTERVILLE	S M EH L T AH R V AH L
SMETHPORT	S M EH TH AH R T
SMG	EH S EH M G
SMICKSBURG	S M IH K S B AH R G
SMILAX	S M IH L AH K S
SMITHBORO	S M IH TH B AH R OW
SMITHDALE	S M IH TH D EY L
SMITHLAND	S M IH TH L AE N D
SMITHMILL	S M IH TH M IH L
SMITHSBURG	S M IH TH S B AH R G
SMITHSHIRE	S M IH TH SH AY ER
SMITHTON	S M IH TH T AH N
SMITHVILLE	S M IH TH V AH L
SMOAKS	S M OW K S
SMOKETOWN	S M OW K T AW N
SMOLAN	S M OW L AH N
SNEADS	S N IY D Z
SNEDEN	S N IY D AH N
SNEDIKER	S N AH D AY K AH R
SNEEDVILLE	S N IY D AH L
SNELLVILLE	S N EH L V AH L
SNOQUALMIE	S N AA K W AA L M AY
SNOWMASS	S N OW M AE S
SNOWVILLE	S N OW V AH L
SNYDERTOWN	S N IH D AH R T OW N
SOBECKO	S AH B EH K OW
SOBRANTE	S AA B R AH N T
SOCORRO	S AH K AO R OW
SODDY	S AA D IY
SODERS	S AA D ER Z
SOLDATOVIC	S OW L D AH T AH V AH K
SOLDOTNA	S OW L D AA T N AH
SOLGOHACHIA	S OW L G AH HH AE CH IY AH
SOLLAS	S AA L AH Z
SOLOMONS	S AA L AH M AH N Z
SOLSBERRY	S AA L Z B EH R IY
SOLVOY	S OW L V OW IY
SOLWAY	S OW L W EY IY
SOMERDALE	S AA M AH R D EY L
SOMERSTOWN	S AA M AH R S T OW N
SOMERSWORTH	S AH M AH R S W AH R TH
SOMIS	S OW M AH S
SOMONAUK	S AA M AH N AH K
SONOITA	S AH N OY T AH
SOPCHOPPY	S AA P CH AA P IY
SOPERTON	S AA P ER T AH N
SOQUEL	S AA K W AH L
SOREN	S OW R AH N
SOSO	S OW S OW
SOTA	S OW T AH
SOULSBYVILLE	S OW L S B AH V AH L
SOUTHAVEN	S AW TH AH V AH N
SOUTHBOROUGH	S AW TH B ER OW
SOUTHBRIDGE	S AW TH B R IH JH
SOUTHBURY	S AW TH B EH R IY
SOUTHFIELDS	S AW TH F IY L D Z
SOUTHHALL	S AW TH HH AO L
SOUTHINGTON	S AW TH IH NG T AH N
SOUTHPOINT	S AW TH P OY N T
SOUTHWES	S AW TH W Z
SP	EH S P
SPANAWAY	S P AE N AH W EY
SPANISHBURG	S P AH N IH SH B AH R G
SPARKILL	S P AA R K IH L
SPARLAND	S P AA R L AE N D
SPARROWBUSH	S P AE R OW B UH SH
SPARTANSBURG	S P AA R T AE N S B AH R G
SPAVINAW	S P AE V AH N AH
SPEARFISH	S P IH ER F IH SH
SPEARSVILLE	S P AH R S V AH L
SPEARVILLE	S P AH R V AH L
SPEEDWELL	S P IY D W EH L
SPENCERPORT	S P EH N S ER P OW R T
SPENCERTOWN	S P EH N S ER T AW N
SPENCERVILLE	S P EH N S AH R V AH L
SPEONK	S P IY AH NG K
SPERRYVILLE	S P EH R AH V AH L
SPICEWOOD	S P AY S W UH D
SPINDALE	S P IH N D EY L
SPINNAKER	S P IH N EY K AH R
SPIRITWOOD	S P IH R AH T W UH D
SPLENDORA	S P L EH N D AH R AH
SPOTSWOOD	S P AA T S W UH D
SPOTTSVILLE	S P AA T S V AH L
SPOTTSWOOD	S P AA T S W UW D
SPRAGGS	S P R AE G Z
SPRAGUEVILLE	S P R AE G W AH V AH L
SPRAKERS	S P R AE K AH R Z
SPRAYVIEW	S P R EY V Y UW
SPRI	S P R IY
SPRIN	S P R IH N
SPRINGBORO	S P R IH N G AH R OW
SPRINGBROOK	S P R IH NG B R UH K
SPRINGERTON	S P R IH NG ER T AH N
SPRINGFIEL	S P R IH N G F IY L
SPRINGHILL	S P R IH NG HH IH L
SPRINGLAKE	S P R IH NG L EY K
SPRINGPORT	S P R IH NG P OW R T
SPRINGTOWN	S P R IH NG T AW N
SPRINGVALE	S P R IH NG V EY L
SPRINGVIEW	S P R IH NG V Y UW
SPRINGVILLE	S P R IH N G AH L
SPRINGWATER	S P R IH NG W AO T ER
SPRITZ	S P R IH T S
SPROUSES	S P R AW Z AH Z
SPRUCEWOOD	S P R UW S W UH D
SPURGER	S P AH R JH AH R
SPUYTEN	S P Y UW AH T AH N
SQ	EH S K
SQ.	EH S K Y UW
SQUANKUM	S K W AA NG K AH M
SQUAW	S K W AO
STAATSBURG	S T AA T S B AH R G
STACYVILLE	S T AE S AH V AH L
STAFFORDSVILLE	S T AE F AO R D S V AH L
STAGAARD	S T AE G AH R D
STAHLSTOWN	S T AE L S T OW N
STALIE	S T EY L IY
STANFORDVILLE	S T AE N F AO R D AH L
STANTONSBURG	S T AE N T AA N S B AH R G
STANTONVILLE	S T AE N T AA N V AH L
STANVILLE	S T AE N V AH L
STANWICH	S T AE N W AH CH
STANWIX	S T AE N W AH K S
STAPLEHURST	S T AE P L AH HH AH R S T
STARFORD	S T AA R F OW R D
STARKSBORO	S T AA R K S B AH R OW
STARRSVILLE	S T AE R S V AH L
STARRUCCA	S T AE R AH K AH
STATENVILLE	S T AH T EH N V AH L
STATESBORO	S T AH T EH Z AH R OW
STATESVILLE	S T AH T EH Z AH L
STATI	S T AE T IY
STATIO	S T EY T IY OW
STATTS	S T AE T S
STEELEVILLE	S T IY L AH V AH L
STEELTON	S T IY L T AH N
STEENS	S T IY N Z
STEENWICK	S T IY N W AH K
STEFFENVILLE	S T EH F EH N V AH L
STEHEKIN	S T EH HH AH K AH N
STEILACOOM	S T IY L AH K UW M
STEINAUER	S T IY N AH AH R
STEINHATCHEE	S T AY N HH AE CH IY
STELTON	S T EH L T AH N
STENTON	S T EH N T AH N
STEPHENSBURG	S T AH F EH N S B AH R G
STEPHENSPORT	S T EH P HH EH N S P OW R T
STEPHENTOWN	S T EH P HH EH N T AW N
STERLINGTON	S T ER L IH NG T AH N
STETSONVILLE	S T EH T S AA N V AH L
STEVENSBURG	S T AH V EH N S B AH R G
STEVENSVILLE	S T AH V EH N S V AH L
STEVINSON	S T AH V IH N S AH N
STEWARDSON	S T UW ER D S AH N
STEWARTSTOWN	S T UW AA R T S T AW N
STEWARTSVILLE	S T Y UW AA R T S V AH L
STEWARTVILLE	S T Y UW AA R T V AH L
STILESVILLE	S T AH L EH Z AH L
STILLWELLS	S T IH L W EH L Z
STIPSONS	S T IH P S AH N Z
STIRUM	S T IH R AH M
STITTVILLE	S T IH T V AH L
STOBE	S T OW B
STOCKPORT	S T AA K P OW R T
STOCKVILLE	S T AA K V AH L
STOKESDALE	S T OW K S D EY L
STON	S T AA N
STONEBORO	S T AH N EH B AH R OW
STONEBRIDGE	S T OW N B R IH JH
STONECREST	S T OW N K R EH S T
STONEFORT	S T OW N F OW R T
STONEGA	S T AA N AH G AH
STONEGATE	S T OW N G EY T
STONEVILLE	S T AA N AH V AH L
STONINGTON	S T OW N IH NG T AH N
STONYFORD	S T OW N IY F OW R D
STORDEN	S T AO R D AH N
STORMVILLE	S T AO R M V AH L
STOTESBURY	S T AH T EH Z Y AH R IY
STOUTLAND	S T AW T L AE N D
STOUTSVILLE	S T AW T S V AH L
STOYSTOWN	S T OY S T OW N
STRABANE	S T R AH B EY N
STRAFFORD	S T R AE F AH R D
STRAITSVILLE	S T R EY T S V AH L
STRANDBURG	S T R AE N D AH R G
STRANDQUIST	S T R AE N D K W AH S T
STRATHAM	S T R AE TH AH M
STRATHCONA	S T R AE TH AH N AH
STRATHMERE	S T R AE TH M AH R
STRATHMORE	S T R AE TH M AH R
STRATTANVILLE	S T R AE T AE N V AH L
STREAMWOOD	S T R IY M W UH D
STREATOR	S T R IY EY T AH R
STREETCARS	S T R IY T K AA R Z
STREETSBORO	S T R IY T S B AH R OW
STRINGTOWN	S T R IH NG T AW N
STROMSBURG	S T R AA M Z AH R G
STRONGHURST	S T R AA N AH R S T
STRONGSTOWN	S T R AO NG Z T AW N
STRONGSVILLE	S T R AA N G S V AH L
STROUDSBURG	S T R AW D S B AH R G
STRYKERSVILLE	S T R AH K AH R S V AH L
STUMPTOWN	S T AH M P T AW N
STUMPY	S T AH M P IY
STUYAHOK	S T Y UW AY AH HH AH K
STYLER	S T AY L ER
SUAMICO	S W EY M AH K OW
SUBIACO	S AH B AY AH K OW
SUBLETTE	S AH B L EH T
SUBLIMITY	S AH B L AY M AH T IY
SUCCASUNNA	S AH K AH S AH N AH
SUCHES	S AH CH IH Z
SUDLERSVILLE	S AH D L AH R S V AH L
SUEUR	S UW AH AH R
SUGARBUSH	SH UH G ER B UH SH
SUGARCREEK	SH UH G ER K R IY K
SUGARLOAF	SH UH G ER L OW F
SUGARTOWN	SH UH G ER T AW N
SUISUN	S UW S AH N
SUITLAND	S UW T L AE N D
SULA	S UW L AH
SULLIGENT	S AH L AH JH AH N T
SUMAS	S UW M AH Z
SUMERCO	S UW M AH R K OW
SUMERDUCK	S AH M ER D AH K
SUMITON	S AH M IY T AH N
SUMMERDALE	S AH M ER D EY L
SUMMERLAND	S AH M ER L AE N D
SUMMERSVILLE	S AH M AH R S V AH L
SUMMERTON	S AH M ER T AH N
SUMMERTOWN	S AH M ER T AW N
SUMMI	S AH M IY
SUNAPEE	S AH N EY P IY
SUNBRIGHT	S AH N B R AY T
SUNBURG	S AH N B AH R G
SUNBURST	S AH N B ER S T
SUNBURY	S AH N B EH R IY
SUNFIELD	S AH N F IY L D
SUNMAN	S AH N M AE N
SUNMOUNT	S AH N M AW N T
SUNNYBRAE	S AH N IY B R EY
SUNNYLAND	S AH N IY L AE N D
SUNNYMEADE	S AH N AH M IY D
SUNOL	S UW N AH L
SUNRAY	S AH N R EY
SUNRIVER	S AH N R IH V ER
SUPAI	S UW P EY
SUQUAMISH	S AH K W AH M AH SH
SURFSIDE	S ER F S AY D
SURGOINSVILLE	S AH R G OY N S V AH L
SURING	SH UH R IH NG
SUSANK	S UW S AH NG K
SUSANVILLE	S UW S AE N V AH L
SUTERSVILLE	S UW T AH R S V AH L
SUTTONS	S AH T AH N Z
SUWANEE	S AH W AH N IY IY
SVEA	S V IY
SW	EH S W
SWAINTON	S W EY N T AH N
SWALEDALE	S W AA L AH D EY L
SWAMPSCOTT	S W AA M P S AH T
SWANQUARTER	S W AA N K W AO R T ER
SWANSBORO	S W AA N S B AH R OW
SWANSEA	S W AA N S IY
SWANVILLE	S W AA N V AH L
SWANWICK	S W AA N W IH K
SWANZEY	S W AA N Z IY
SWARTZEL	S W AO R T S AH L
SWATARA	S W AA T AH R AH
SWAYZEE	S W EY Z IY IY
SWEA	S W IY
SWEDESBORO	S W AH D EH Z AH R OW
SWEETBROOK	S W IY T B R UH K
SWEETGRASS	S W IY T G R AE S
SWEETGUM	S W IY T G AH M
SWEETWOOD	S W IY T W UH D
SWEETWOODS	S W IY T W UH D Z
SWIFTON	S W IH F T AO N
SWIFTWATER	S W IH F T W AO T ER
SWINNERTON	S W IH N AH R T AH N
SWISSHOME	S W IH S OW M
SWISSVALE	S W IH S V EY L
SWITZ	S W IH T S
SWORMVILLE	S W AH R M V AH L
SYKESTON	S AH K EH S T AH N
SYKESVILLE	S AH K EH Z AH L
SYLACAUGA	S AH L AE K AH G AH
SYLVATON	S IH L V AH T AH N
SYMSONIA	S IH M Z OW N Y AH
SYOSSET	S AY AA S AH T
SYRINGA	S AH R IH NG G AH
SZOLD	S Z OW L D
T.B.T.A.	T IY B IY T IY EY
TABERG	T AE B AH R G
TABIONA	T EY B IY AH N AH
TACONIC	T AE K AH N AH K
TAFTON	T AE F T AH N
TAFTSVILLE	T AE F T S V AH L
TAFTVILLE	T AE F T V AH L
TAHLEQUAH	T AH L EH K W AH
TAHOKA	T AE HH AH K AH
TAHOLAH	T AE HH AH L AH
TAHOMA	T AE HH AH M AH
TAHUYA	T AE HH Y UW AY AH
TAIBAN	T EY B AH N
TAKOMA	T AH K OW M AH
TALALA	T AE L AH L AH
TALBOTTON	T AE L B AA T AH N
TALCO	T AE L K OW
TALIHINA	T AH L IH HH AH N AH
TALKEETNA	T AE L K IY T N AH
TALLAPOOSA	T AE L AH P UW S AH
TALLASSEE	T AO L AE S IY
TALLEYVILLE	T AE L EY V AH L
TALLMANSVILLE	T AE L M AE N S V AH L
TALMO	T AE L M OW
TALMOON	T AH M UW N
TALOGA	T AE L AH G AH
TALPA	T AE L P AH
TAMAQUA	T AH M AE K W AH
TAMARACK	T AE M AH R AH K
TAMAROA	T AH M AE R OW AH
TAMASSEE	T AE M AH S IY IY
TAMIMENT	T EY M IY M AH N T
TAMINNEN	T AH M IH N AH N
TAMMS	T AE M Z
TAMO	T AE M OW
TAMPICO	T AE M P AH K OW
TAMWORTH	T AE M W AH R TH
TANANA	T AE N AH N AH
TANEYTOWN	T EY N AH T OW N
TANEYVILLE	T EY N EY V AH L
TANGIER	T AE NG IY ER
TANNERSVILLE	T AE N AH R S V AH L
TANNERY	T AE N AH R IY
TANYARD	T AE N Y AA R D
TAOPI	T EY AH P IY
TAPAWINGO	T AE P AH W IH N G OW
TAPOCO	T AE P AH K OW
TAPPAHANNOCK	T AE P AH HH AE N AH K
TARAWA	T AE R AH AH
TARBORO	T AA R B AH R OW
TARENTUM	T AH R EH N T AH M
TARGEE	T AA R JH IY IY
TARIFFVILLE	T AH R IH F V AH L
TARKIO	T AA R K IY OW
TARLEE	T AA R L IY
TARN	T AA R N
TARRS	T AE R Z
TARZANA	T AA R Z AH N AH
TASSELL	T AE S AH L
TASWELL	T AE S W AH L
TATEVILLE	T AE T AH V AH L
TAVISTOCK	T AH V IH S T AH K
TAWAS	T AO AH Z
TAXTER	T AE K S T AH R
TAYCHEEDAH	T EY CH IY D AH
TAYLORSVILLE	T EY L AO R S V AH L
TAYLORTOWN	T EY L AH R T OW N
TAZEWELL	T AE Z UW AH L
TCHULA	CH UW L AH
TCU	T K UW
TEABERRY	T IY B EH R IY
TEARDROP	T IH ER D R AA P
TEATICKET	T IY T IH K AH T
TECATE	T IY K EY T
TECHNY	T EH K N IY
TECOPA	T EH K AH P AH
TEEC	T IY K
TEGA	T EH G AH
TEHAMA	T EH HH AH M AH
TEKAMAH	T EH K AH M AH
TEKOA	T EH K OW AH
TEKONSHA	T AH K AA N SH AH
TELLICO	T EH L AH K OW
TEMPERANCEVILLE	T EH M P AH R AE N S AH V AH L
TEMVIK	T EH M V AH K
TENAFLY	T EH N AH F L AY
TENAHA	T EH N AH HH AH
TENBROECK	T EH N B R OW AH K
TENBY	T EH N B AY
TENINO	T EH N AH N OW
TENMILE	T EH N M AY L
TENNERTON	T EH N ER T AH N
TENNILLE	T EH N AH L
TENSED	T EH N S T
TENSTRIKE	T EH N S T R AY K
TEQUESTA	T EH K W EH S T AH
TER.	T EH R
TERERRO	T AH R EH R OW
TERLINGUA	T AH R L IH N G W AH
TERLTON	T AH R L T AH N
TERMO	T AH R M OW
TERR	T EH R
TERR.	T EH R
TERRAC	T EH R AH K
TERRETON	T EH R AH T AH N
TERRIL	T EH R AH L
TERRYTOWN	T EH R IY T AW N
TERRYVILLE	T EH R AH V AH L
TETERBORO	T AH T AH R B AH R OW
TETONIA	T AH T OW N Y AH
TEUTOPOLIS	T Y UW T AA P AH L AH S
TEXHOMA	T EH K S AH M AH
TEXICO	T EH K S AH K OW
TEXLINE	T EH K S L AY N
TEXOLA	T EH K S AH L AH
THACKARA	TH AE K AH R AH
THACKERVILLE	TH AE K AH R V AH L
THATFORD	TH AE T AH R D
THAWVILLE	TH AO V AH L
THEILMAN	TH IY L M AH N
THELONIOUS	TH AH L OW N IY AH S
THIBODAUX	TH IH B AH D AH K S
THIDA	TH IH D AH
THIELLS	TH IY L Z
THIERIOT	TH IY R IY AH T
THOLLEN	TH AA L AH N
THOMASBORO	TH AH M AE Z AH R OW
THOMASTON	TH AH M AE S T AH N
THOMPSONTOWN	TH AA M P S AH N T OW N
THOMPSONVILLE	TH AA M P S AA N V AH L
THONOTOSASSA	TH AA N AH T AH S AE S AH
THORNALL	TH AO R N AO L
THORNBROOK	TH AO R N B R UH K
THORNDALE	TH AO R N D EY L
THORNTOWN	TH AO R N T AW N
THORNVILLE	TH AO R N V AH L
THORNWOOD	TH AO R N W UH D
THORNYCROFT	TH AO R N IY K R AO F T
THOROFARE	TH AO R AH F AH R
THORSBY	TH AO R S B IY
THROCKMORTON	TH R AA K M AO R T AH N
THROGS	TH R AA G Z
THWAITES	TH W EY T S
TICES	T AY S AH Z
TICETOWN	T IH S AH T OW N
TICHNOR	T IH K N AH R
TICKFAW	T IH K AH
TIDIOUTE	T IH D IY AH Y UW T
TIEBOUT	T AY B AW T
TIERRA	T IY R AH
TIETON	T AY T AH N
TIGARD	T IH G AH R D
TIGERTON	T AY G ER T AH N
TIGERVILLE	T AH JH AH R V AH L
TIJERAS	T IH JH AH R AH Z
TILINE	T AH L AY N
TILLAMOOK	T IH L AH M AH K
TILLARY	T IH L EH R IY
TILLATOBA	T IH L AE T AH B AH
TILLEDA	T IH L AH D AH
TILTONSVILLE	T IH L T AA N S V AH L
TIMBERVILLE	T IH M B AH R V AH L
TIMBO	T IH M B OW
TIMEWELL	T AY M W EH L
TIMMONSVILLE	T IH M AA N S V AH L
TIMPAS	T IH M P AH Z
TINNIE	T IH N IY
TIOGA	T AY AH G AH
TIONESTA	T AY AH N EH S T AH
TIPLERSVILLE	T IH P L AH R S V AH L
TIPPECANOE	T IH P EH K AH N OW
TIPTONVILLE	T IH P T AA N V AH L
TIPTOP	T IH P T AA P
TIRO	T IH R OW
TISBURY	T IY Z B EH R IY
TISHOMINGO	T IH SH AH M IH N G OW
TISKILWA	T IH S IH L W AH
TITONKA	T AH T AO NG K AH
TIVERTON	T AH V AH R T AH N
TOADLENA	T OW D L AH N AH
TOANO	T OW N OW
TOBACCOVILLE	T AH B AE K AH V AH L
TOBINSPORT	T AH B IH N S AH R T
TOBYHANNA	T AA B AH HH AE N AH
TOCCOA	T AA K OW AH
TODDVILLE	T AA D AH L
TODDY	T AA D IY
TOHATCHI	T AA HH AH CH IY
TOIVOLA	T OY V AH L AH
TOKELAND	T AA K AH L AH N D
TOLLESBORO	T AA L EH Z AH R OW
TOLLHOUSE	T OW L HH AW S
TOLONO	T AA L AH N OW
TOLOVANA	T AH L AA V AH N AH
TOLUCA	T AH L UW K AH
TOMBALL	T AA M B AO L
TOMNOLEN	T AA M N AH L AH N
TOMPKINSVILLE	T AA M P IH N S V AH L
TONALEA	T AH N EY L IY AH
TONASKET	T AH N AE S AH T
TONGANOXIE	T AA N G AH N AA K S AY
TONICA	T AA N AH K AH
TONKAWA	T AO NG K AH AH
TONKING	T AH N K IH NG
TONNELLE	T AA N AH L
TONOPAH	T AA N AH P AH
TONSOR	T AH N Z ER
TONTINE	T AH N T AY N
TOOELE	T UW IY L
TOOMSBORO	T UW M Z AH R OW
TOOMSUBA	T UW M Z UW B AH
TOPOCK	T AA P AH K
TOPONAS	T AA P AH N AH Z
TOPPENISH	T AA P AH N IH SH
TOPSFIELD	T AA P S F IY L D
TOPSHAM	T AA P SH AE M
TOPSIDE	T AA P S AY D
TOPTON	T AA P T AH N
TORRECELLI	T AO R AH S EH L IY
TOSTON	T UW Z T AH N
TOTOWA	T AA T OW AH
TOTTENVILLE	T AA T EH N V AH L
TOTZ	T AA T S
TOUGHKENAMON	T AW K EH N AH M AH N
TOULON	T AW L AH N
TOUTLE	T AW T AH L
TOWACO	T OW AH K OW
TOWANDA	T OW AE N D AH
TOWAOC	T OW EY AH K
TOWNSENDS	T AW N S EH N D Z
TOWNSHI	T OW N SH IY
TOWNVILLE	T OW N V AH L
TOXAWAY	T AA K S AO EY IY
TOXEY	T AA K S IY
TPK	T IY P IY K
TPK.	T IY P IY K EY
TPKE.	T P K
TRACYS	T R EY S IY Z
TRAILOR	T R EY L ER
TRAMCAR	T R AE M K AA R
TRAMCARS	T R AE M K AA R Z
TRAMM	T R AE M
TRAMMS	T R AE M Z
TRAMMY	T R AE M IY
TRANQUILLITY	T R AE NG K W IH L IH T IY
TRANSFIGURATION	T R AE N S F IH G Y ER EY SH AH N
TRANTOR	T R AE N T AH R
TRAPHILL	T R AE P HH IH L
TRASKWOOD	T R AE S W UW D
TRATMAN	T R AE T M AH N
TRAUNIK	T R AO N AH K
TREETZ	T R IY T S
TREMENTINA	T R AH M EH N T AH N AH
TREMLEY	T R EH M L IY
TREMONTAV	T R AH M AA N T AH V
TREMONTON	T R AH M AA N T AH N
TREMPEALEAU	T R EH M P IY L IY UW
TREVETT	T R EH V AH T
TREVORTON	T R AH V AO R T AH N
TREXLERTOWN	T R EH K S L AH R T OW N
TREYNOR	T R EY N AH R
TREZEVANT	T R EH Z AH V AH N T
TRIADELPHIA	T R AY AH D EH L F IY AH
TRIANGL	T R AY AH N G L
TRIDELL	T R IH D AH L
TRILLA	T R IH L AH
TRIMONT	T R IH M AH N T
TRINA	T R IH N AH
TRINCHERA	T R IH NG K AH R AH
TRION	T R AY AH N
TRIPFROM	T R IH P R AH M
TRIST	T R IH S T
TRIVOLI	T R IH V AH L IY
TRL	T IY AA R L
TROSSACH	T R AA S AH CH
TROTTERS	T R AA T ER Z
TROTWOOD	T R AA T W UH D
TROUPSBURG	T R UW P S B AH R G
TROUTDALE	T R AW T D EY L
TROUTVILLE	T R AW T V AH L
TRUCKELMANS	T R AH K EH L M AH N Z
TRUCKLEMANS	T R AH K L AH M AH N Z
TRUFANT	T R UW F AH N T
TRUMANSBURG	T R UW M AE N S B AH R G
TRUSSVILLE	T R AH S V AH L
TRUXTON	T R AH K S T AH N
TSAILE	T S EY AH L
TUALATIN	T Y UW AE L AH T AH N
TUCKAHOE	T AH K AH HH OW
TUCKASEGEE	T AH K AH S AH JH IY IY
TUCKERTON	T AH K ER T AH N
TUCUMCARI	T Y UW K AH M K AH R IY
TUFTONBOR	T AH F T AO N B IY ER
TUJUNGA	T Y UW JH AH N G AH
TUKWILA	T AH K W AH L AH
TULARE	T Y UW L AH R
TULAROSA	T Y UW L AE R AH S AH
TULELAKE	T Y UW L AH L EY K
TULFAN	T AH L F AH N
TULLYTOWN	T UW L IY T AW N
TULUKSAK	T Y UW L AH K S AH K
TUMBRIDGE	T AH M B R AH JH
TUMTUM	T AH M T AH M
TUN	T AH N
TUNBRIDGE	T AH N B R AH JH
TUNNELTON	T AH N AH L T AH N
TUNUNAK	T Y UW N Y UW N AH K
TUPMAN	T AH P M AH N
TURBOTVILLE	T AH R B AA T V AH L
TURLOCK	T AH R L AH K
TURNBURY	T ER N B EH R IY
TURNERS	T ER N ER Z
TURNERSVILLE	T AH R N AH R S V AH L
TURNERTOWN	T ER N ER T AW N
TURNEUR	T AH R N AH R
TURTLEPOINT	T ER T AH L P OY N T
TURTLETOWN	T ER T AH L T AW N
TUSCARORA	T AH S AE R AH R AH
TUSCOLA	T AH S AH L AH
TUSCUMBIA	T AH S AH M B IY AH
TUSKAHOMA	T AH S AE HH AH M AH
TUSSY	T AH S IY
TUYL	T Y UW AH L
TWAITS	T W EY T S
TWELLS	T W EH L Z
TWENTYNINE	T W EH N T IY N AY N
TWINBRIDGE	T W IH N B R IH JH
TWISP	T W IH S
TWODOT	T W AA D AH T
TWP	T IY D AH B AH L Y UW P
TWP.	T IY D AH B AH L Y UW P IY
TYASKIN	T AY AE S AH N
TYBEE	T AY B IY IY
TYLERS	T IH L AH R Z
TYLERTON	T AH L AH R T AH N
TYLERTOWN	T IH L AH R T OW N
TYNDALE	T IH N D EY L
TYNGSBORO	T IH N G S B AH R OW
TYONEK	T AY AH N AH K
TYRELLAN	T AH R EH L AH N
TYRONZA	T AH R AA N Z AH
TYSEN	T AY Z AH N
TYSENS	T IH S AH N Z
U.S.	Y UW EH S
UA	Y UW AH
UBLY	AH B L IY
UCTS	AH K T S
UHRICHSVILLE	AH R IH CH S V AH L
UKIAH	Y UW K AY AH
ULEN	Y UW L AH N
ULER	Y UW L AH R
ULLA	AH L AH
ULLIN	AH L AH N
ULVAH	AH L V AH
UMCP	AH M K
UMPQUA	AH M P W AH
UNADILLA	AH N AH D IH L AH
UNAKA	AH N AE K AH
UNALAKLEET	AH N AE L AH K L IY T
UNALASKA	AH N AH L AE S AH
UNAMI	AH N AE M IY
UNCAS	AH N K AE Z
UNCASVILLE	AH N K AE Z AH L
UNDERCLIFF	AH N D ER K L IH F
UNICOI	Y UW N IH K OW IY
UNIONPORT	Y UW N Y AH N P OW R T
UNIONTOWN	Y UW N Y AH N T AW N
UNIONVILLE	Y UW N AH AA N V AH L
UNITYVILLE	Y UW N AH T IH V AH L
UNIV	AH N IH V
UNIVE	Y UW N AH V
UNIVER	Y UW N AH V AH R
UNIVERSI	Y UW N AH V AH R S IY
UPATOI	Y UW P AH T OY
UPPERGLADE	AH P AH R G L EY D
UPPERSTRASBURG	AH P AH R S T R AE Z AH R G
UPPERVILLE	AH P AH R V AH L
UPSALA	AH P S AH L AH
URBANDALE	ER B AH N D EY L
URBANOWITZ	AH R B AE N OW AH T S
URIAH	Y UH R AY AH
URMA	AH R M AH
URSINA	AH R S AH N AH
USK	AH S
UTE	Y UW T IY
UTLEYVILLE	AH T L EY V AH L
UTRECHT	AH T R AH CH T
UVALDA	Y UW V AE L D AH
UVALDE	Y UW V AH L D
UXBRIDGE	AH K S B R AH JH
VA	V AA
VACHERIE	V AH CH IY R AY
VADA	V AE D AH
VADITO	V AE D AH T OW
VAIDEN	V EY D AH N
VALATIE	V EY L AH T IY
VALDERS	V AE L D AH R Z
VALDESE	V AE L D IY Z
VALHERMOSO	V AE L HH AH R M AH S OW
VALIER	V AE L Y ER
VALLECITO	V AE L EH S AH T OW
VALLECITOS	V AE L EH S AH T AH Z
VALLEYFORD	V AE L IY F OW R D
VALLEYVIEW	V AE L IY V Y UW
VALLONIA	V AE L OW N Y AH
VALLSCREEK	V AE L S R IY K
VALMERE	V AE L M AH R
VALMORA	V AE L M AH R AH
VALRICO	V AE L R AH K OW
VALYERMO	V AE L AY AH R M OW
VANCEBORO	V AE N S EH B AH R OW
VANDALIA	V AE N D EY L Y AH
VANDELINDA	V AE N D AH L IH N D AH
VANDEMERE	V AE N D IY M IH ER
VANORE	V AE N OW R
VARANDA	V AH R AE N D AH
VARDAMAN	V AA R D AH M AH N
VARET	V AE R AH T
VARKENS	V AA R K AH N Z
VARNA	V AA R N AH
VARNVILLE	V AA R N V AH L
VARYSBURG	V AH R IH Z AH R G
VASHON	V AE SH AH N
VASSALBORO	V AE S AE L B AH R OW
VEALMOOR	V IY L M UH R
VEBLEN	V EH B L AH N
VEDRA	V EH D R AH
VEEDERSBURG	V IY D AH R S B AH R G
VEGUITA	V EH G W AH T AH
VEIGH	V EY
VELDE	V EH L D
VELPEN	V EH L P AH N
VELTHOVEN	V EH L TH AH V AH N
VELVA	V EH L V AH
VENEDOCIA	V EH N AH D OW SH IY AH
VENEDY	V EH N AH D IY
VENETA	V EH N AH T AH
VENETIA	V AH N IY SH IY AH
VENETIE	V AH N IY T AY
VENTNOR	V EH N T N AH R
VENTURIA	V EH N T Y UH R IY AH
VERADALE	V EH R AH D EY L
VERANDAH	V AH R AE N D AH
VERBANK	V AH R B AH NG K
VERDEL	V AH R D AH L
VERDEN	V ER D AH N
VERDIGRE	V AH R D AH G AH R
VERGAS	V AH R G AH Z
VERGENNES	V AH R JH AH N Z
VERGNE	V AH R N
VERHALEN	V EH R AH L AH N
VERMONTVILLE	V AH R M AA N T V AH L
VERNDALE	V AH R N D EY L
VERNIA	V AH R N IY AH
VERSHIRE	V AH R SH AY R
VERVEELEN	V AH R V IY L AH N
VESELI	V EH S AH L IY
VESTABURG	V EH S T AH B AH R G
VESTAVIA	V EH S T EY V IY AH
VESTRY	V EH S T R IY
VETAL	V EH T AH L
VEYO	V EY OW
VEYTOWN	V EY T OW N
VIBORG	V IH B AH R G
VIBURNUM	V AH B AH R N AH M
VICCO	V IH K OW
VICI	V IH S IY
VIELLE	V IY L
VIEWTOWN	V Y UW T AW N
VII	V IY
VIL	V IH L
VILL	V IH L
VILLAG	V IH L AH G
VILLEGREEN	V IH L EH G R IY AH N
VILLISCA	V IH L IH S AH
VILONIA	V AH L OW N Y AH
VINALHAVEN	V AY N AH L HH EY V AH N
VINEMONT	V IH N AH M AH N T
VINMONT	V IH N M AH N T
VINTONDALE	V IH N T AH N D EY L
VIREO	V IH R IY OW
VIRGILINA	V AH R JH IH L AH N AH
VIROQUA	V AH R AA K W AH
VIRTUA	V AH R T Y UW AH
VISALIA	V AH S EY L Y AH
VLECK	V L EH K
VLEIGH	V L EY
VLG	V IY EH L G
VLIETS	V L IY T S
VLLGE	V L JH
VOCA	V OW K AH
VOLANT	V OW L AH N T
VOLBORG	V OW L B AH R G
VOLODYMYR	V AH L AA D AH M AH R
VOLUNTOWN	V AA L AH N T OW N
VOMEL	V AA M AH L
VONORE	V AA N AH R
VOORHEESVILLE	V AH R IY Z AH L
VORST	V AO R S T
VOSSBURG	V AA S B AH R G
VOSSELLER	V AA S EH L AH R
VOWINCKEL	V OW IH NG K AH L
VREDENBURGH	V R AH D EH N B AH R
VYSE	V AY Z
WABAN	W EY B AH N
WABASHA	W AA B AH SH AH
WABASSO	W AH B AE S OW
WABBASEKA	W AA B AE S AH K AH
WABENO	W AA B AH N OW
WACCABUC	W AE K AH B AH K
WACCAMAW	W AE K AH M AH
WACONIA	W AH K OW N Y AH
WADENA	W AA D AH N AH
WADESBORO	W AH D EH Z AH R OW
WADESTOWN	W EY D AH S T OW N
WADESVILLE	W AH D EH Z AH L
WADMALAW	W AA D M AH L AH
WAELDER	W IY L D AH R
WAGARAW	W AE G AH R AO
WAGARVILLE	W AH G AA R V AH L
WAGENEN	W EY JH AH N AH N
WAGRAM	W AE G R AE M
WAHIAWA	W AH HH IY AH AH
WAHKIACUS	W AH K IY AH S AH S
WAHKON	W AE K AH N
WAIALUA	W EY AH L UW W AH
WAIANAE	W EY AH N IY
WAILUKU	W EY L UW K UW
WAIMANALO	W EY M AE N AH L OW
WAIMEA	W EY M IY AH
WAIMER	W EY M AH R
WAIPAHU	W EY P AH HH UW
WAITEVILLE	W EY T AH V AH L
WAITSBURG	W EY T S B AH R G
WAITSFIELD	W EY T S F IY L D
WAKARUSA	W AE K AH R UW S AH
WAKITA	W AE K AH T AH
WAKONDA	W AH K AA N D AH
WAKPALA	W AE K AH L AH
WAL-MART	W AO L M AA R T
WALBROOKE	W AA L B R AH K
WALDANE	W AA L D EY N
WALDANS	W AA L D AH N Z
WALDBAUMS	W AA L D AH M Z
WALDOBORO	W AA L D AA B AH R OW
WALDORF=ASTORIA	W AO L D AO R F AE S T AO R IY AH
WALDPORT	W AA L D P AH R T
WALDWICK	W AA L D W AH K
WALESKA	W AH L EH S AH
WALHALLA	W AA L HH AE L AH
WALHONDING	W AA L HH AA N D AH NG
WALKERSVILLE	W AA L K AH R S V AH L
WALKERTON	W AO K ER T AH N
WALKERTOWN	W AO K ER T AW N
WALKERVILLE	W AA L K AH R V AH L
WALLABOUT	W AO L AH B AW T
WALLAND	W AA L AH N D
WALLASTON	W AA L AE S T AH N
WALLBACK	W AO L B AE K
WALLINS	W AO L IH N Z
WALLISVILLE	W AA L IH Z AH L
WALLKILL	W AO L K IH L
WALLOON	W AA L UW N
WALLOWA	W AA L OW AH
WALLPACK	W AO L P AE K
WALLSBURG	W AA L S B AH R G
WALNUTPORT	W AO L N AH T P OW R T
WALSHVILLE	W AA L SH V AH L
WALSTONBURG	W AA L S T AA N B AH R G
WALTERSBURG	W AA L T AH R S B AH R G
WALTHILL	W AA L TH AH L
WALTONVILLE	W AA L T AA N V AH L
WALTUMA	W AA L T Y UW M AH
WALUM	W AA L AH M
WAMEGO	W AA M AH G OW
WAMIC	W AE M AH K
WAMSUTTER	W AA M Z AH T AH R
WANA	W AA N AH
WANAKENA	W AH N AE K AH N AH
WANAMINGO	W AA N AH M IH N G OW
WANAQUE	W AA N AH K
WANATAH	W AA N AH T AH
WANBLEE	W AA N B L IY IY
WANDO	W AA N D UW
WANETTE	W EY N EH T
WANNASKA	W AA N AE S AH
WANTAGH	W AA N T AH
WAPAKONETA	W AA P AH K AA N AH T AH
WAPANUCKA	W AA P AH N AH K AH
WAPATO	W AA P AH T OW
WAPELLA	W AH P EH L AH
WAPELLO	W AH P EH L OW
WAPPAPELLO	W AA P AH P EH L OW
WAPWALLOPEN	W AA P W AA L AH P AH N
WARBA	W AO R B AH
WARDENSVILLE	W AO R D EH N S V AH L
WARDSBORO	W AO R D S B AH R OW
WARDVILLE	W AO R D AH L
WAREHAM	W EH R HH AE M
WARETOWN	W EH R T AW N
WARFORDSBURG	W AO R F AO R D S B AH R G
WARMSPRINGS	W AO R M S P R IH NG Z
WARNERVILLE	W AO R N AH R V AH L
WARRENDALE	W AO R AH N D EY L
WARRENSBURG	W AO R EH N S B AH R G
WARRENSVILLE	W AO R EH N S V AH L
WARRENVILLE	W AO R EH N V AH L
WARROAD	W AO R OW D
WARSOFF	W AO R Z AO F
WARTBURG	W AO R T B AH R G
WARTRACE	W AO R T R EY S
WASECA	W AA S AH K AH
WASHAKIE	W AH SH EY K AY
WASHGTIN	W AA SH G T AH N
WASHINGTONVILLE	W AA SH AH N G T AA N V AH L
WASHOUGAL	W AH SH AW G AH L
WASHTA	W AA SH T AH
WASHTUCNA	W AA SH T AH K N AH
WASILLA	W AH S IH L AH
WASKISH	W AA S AH SH
WASKOM	W AA S AH M
WASSAIC	W AA S EY AH K
WASTA	W AA S T AH
WATAGA	W AA T AH G AH
WATAUGA	W AA T AH G AH
WATCHMANS	W AA CH M AE N Z
WATCHOGUE	W AA CH AH G
WATCHUNG	W AA CH AH NG
WATERBORO	W AH T AH R B AH R OW
WATERFLOW	W AO T ER F L OW
WATERPORT	W AO T ER P OW R T
WATERSIDE	W AO T ER S AY D
WATERSMEET	W AO T ER Z M IY T
WATERVIEW	W AO T ER V Y UW
WATERVLIET	W AA T AH R V L IY T
WATERWITCH	W AO T ER W IH CH
WATHA	W AA TH AH
WATHENA	W AA TH AH N AH
WATJEAN	W AA T JH IY AH N
WATKINSVILLE	W AA T IH N S V AH L
WATONGA	W AH T AA N G AH
WATSEKA	W AA T S AH K AH
WATSESSING	W AA T S EH S AH NG
WATSONTOWN	W AA T S AH N T OW N
WATTSBURG	W AA T S B AH R G
WAUBAY	W AO B EY IY
WAUBEKA	W AO B AH K AH
WAUBUN	W AO B AH N
WAUCHULA	W AH CH UW L AH
WAUCOMA	W AO K AH M AH
WAUCONDA	W AH K AA N D AH
WAUGHAW	W AO AH
WAUKEE	W AH K IY IY
WAUKOMIS	W AO K AH M AH S
WAUKON	W AO K AH N
WAUMANDEE	W AO M AH N D IY IY
WAUNAKEE	W AO N AH K IY IY
WAUNETA	W AO N AH T AH
WAUPACA	W AO P AH K AH
WAUPUN	W AO P AH N
WAURIKA	W AO R AH K AH
WAUSA	W AO S AH
WAUSAUKEE	W AO S AH K IY IY
WAUSEON	W EY AH S IY AH N
WAUTOMA	W AO T AH M AH
WAUWATOSA	W AH W AA T AH S AH
WAUZEKA	W AO Z AH K AH
WAVECREST	W EY V K R EH S T
WAVELAND	W EY V L AE N D
WAWAKA	W AO AH K AH
WAXAHACHIE	W AE K S AE HH AH CH AY
WAYAN	W EY AH N
WAYDELL	W EY D EH L
WAYMART	W EY M AA R T
WAYNESBURG	W EY N EH Z AH R G
WAYNESFIELD	W EY N AH S IY L D
WAYNETOWN	W EY N EH T OW N
WAYNEWOOD	W EY N Y UW UW D
WAYNOKA	W EY N AH K AH
WAYZATA	W EY Z AH T AH
WEARE	W IY R
WEATOGUE	W IY T AH G
WEAUBLEAU	W IY AH B L IY UW
WEAVERVILLE	W IY V AH R V AH L
WEBBERS	W EH B ER Z
WEBBERVILLE	W EH B AH R V AH L
WEBBVILLE	W EH B AH L
WEBRO	W EH B R OW
WEDGEFIELD	W EH JH F IY L D
WEEDSPORT	W IY D S P OW R T
WEEDVILLE	W IY D AH L
WEHRAN	W EH R AH N
WEIPPE	W IY P
WEIRFIELD	W IH ER F IY L D
WEIRSDALE	W IH ER Z D EY L
WEISSPORT	W IY S AH R T
WELCHES	W EH L CH IH Z
WELCHS	W EH L CH S
WELDA	W EH L D AH
WELDONA	W EH L D AH N AH
WELEETKA	W IY L IY T AH
WELLBROOK	W EH L B R UH K
WELLFORD	W EH L F OW R D
WELLHOUSE	W EH L HH AW S
WELLPINIT	W EH L P AH N AH T
WELLSBORO	W EH L S B AH R OW
WELLSBURG	W EH L S B AH R G
WELLSTON	W EH L Z T AH N
WELLSVILLE	W EH L S V AH L
WELLTON	W EH L T AH N
WEMROCK	W EH M R AH K
WENDOVER	W EH N D OW V AH R
WENHAM	W EH N HH AH M
WENLOCK	W EH N L AH K
WENONAH	W EH N AH N AH
WEOGUFKA	W IY AH G AH F AH
WERNERSVILLE	W AH R N AH R S V AH L
WESCOSVILLE	W EH S AA Z AH L
WESER	W IY Z ER
WESKAN	W EH S AH N
WESLACO	W EH Z L AH K OW
WESLEYVILLE	W EH Z L EY V AH L
WESSINGTON	W IY Z IH NG T AH N
WESTAWAY	W EH S T AH W EY
WESTBEND	W EH S T B EH N D
WESTBOURNE	W EH S T B OW R N
WESTCLIFFE	W EH S T L AH F
WESTDALE	W EH S T D EY L
WESTENTRY	W EH S T AH N T R IY
WESTERLO	W EH S T AH R L OW
WESTERNVILLE	W EH S T AH R N V AH L
WESTERVILLE	W EH S T AH R V AH L
WESTFIR	W EH S T F ER
WESTHAVEN	W EH S T HH EY V AH N
WESTHOPE	W EH S T HH OW P
WESTMONT	W EH S T M AH N T
WESTMORLAND	W EH S T M AO R L AH N D
WESTPOINT	W EH S T P OY N T
WESTSHORE	W EH S T SH OW R
WESTTOWN	W EH S T AW N
WESTVELT	W EH S T V AH L T
WESTVIEW	W EH S T V Y UW
WESTVILLE	W EH S T V AH L
WETHEROLE	W EH TH AH R OW L
WETHERSFIELD	W EH DH ER Z F IY L D
WETONKA	W AH T AO NG K AH
WETUMKA	W AH T AH M K AH
WETUMPKA	W AH T AH M P AH
WEVERTOWN	W EH V AH R T OW N
WEWAHITCHKA	W UW AH HH IH CH AH
WEWANNA	W UW AE N AH
WEWELA	W UW AH L AH
WEXFORD	W EH K S AH R D
WEYAUWEGA	W EY AO W AH G AH
WHALAN	W EY L AH N
WHALEYSVILLE	W EY L EY Z AH L
WHALLONSBURG	W AA L AA N S B AH R G
WHARNCLIFFE	W AO R NG K L AH F
WHEATFIELD	W IY T F IY L D
WHEATLAND	W IY T L AE N D
WHEELERSBURG	W IY L AH R S B AH R G
WHICK	W IH K
WHIDBEY	W IH D IY
WHIPHOLT	W AH F OW L T
WHITAKERS	W IH T AH K AH R Z
WHITALL	W IH T AO L
WHITEFACE	W AY T F EY S
WHITELAND	W AY T L AE N D
WHITEMARSH	W AY T M AA R SH
WHITEROCKS	W AY T R AA K S
WHITESBORO	W AH T EH Z AH R OW
WHITESBURG	W AH T EH Z AH R G
WHITESTOWN	W AY T AH S T OW N
WHITESVILLE	W AH T EH Z AH L
WHITETHORNE	W IH T AH TH AH R N
WHITETOP	W AY T AA P
WHITEVILLE	W IH T AH V AH L
WHITEWOOD	W AY T W UH D
WHITEWRIGHT	W AY T R AY T
WHITINGHAM	W AY T IH NG HH AE M
WHITINSVILLE	W AH T IH N S V AH L
WHITLASH	W IH T L AE SH
WHITLEYVILLE	W IH T L EY V AH L
WIBAUX	W IH B AH K S
WIBORG	W IH B AH R G
WICKAPECKO	W IH K AH P EH K OW
WICKENBURG	W IH K EH N B AH R G
WICKFORD	W IH K F OW R D
WICKLOW	W IH K L OW
WICOMICO	W AY K AA M IH K OW
WICONISCO	W IH K AH N IH S OW
WIEDERER	W IY D IY R AH R
WIERGATE	W IY R G EY T
WILBRAHAM	W IH L B R AH HH AH M
WILBURTHA	W IH L B AH R TH AH
WILBURTON	W IH L B AH R T AH N
WILDERSVILLE	W IH L D AH R S V AH L
WILDERVILLE	W IH L D AH R V AH L
WILDOMAR	W IH L D AH M AH R
WILDORADO	W AY L D ER AH D UW
WILDROSE	W AY L D R OW Z
WILEYVILLE	W AH L EY V AH L
WILKINSBURG	W IH L K IH N S B AH R G
WILKINSONVILLE	W IH L K AH N S AA N V AH L
WILKSHIRE	W IH L K AY R
WILLACOOCHEE	W IH L AH K AH CH IY IY
WILLARDS	W IH L AH R D Z
WILLIAMSBRIDGE	W IH L Y AH M Z B R IH JH
WILLIAMSFIELD	W IH L Y AH M Z F IY L D
WILLIAMSPO	W IH L IY AE M S OW
WILLIAMSTON	W IH L Y AH M Z T AH N
WILLIAMSVILLE	W IH L IY AE M Z AH L
WILLIMANTIC	W IH L IH M AE N T IH K
WILLINGBORO	W IH L IH N G AH R OW
WILLINGTON	W IH L IH NG T AH N
WILLISBURG	W IH L IH Z AH R G
WILLISVILLE	W IH L IH Z AH L
WILLMAR	W IH L M AA R
WILLMOHR	W IH L M AH R
WILLOWICK	W IH L OW AH K
WILLOWMERE	W IH L OW M IH ER
WILLOWWOOD	W IH L OW W UH D
WILLSBORO	W IH L S B AH R OW
WILLSEYVILLE	W IH L S EY V AH L
WILLSHIRE	W IH L SH AY ER
WILMONT	W IH L M AH N T
WILPEN	W IH L P AH N
WILRUE	W IH L R UW
WILSALL	W IH L S AH L
WILSEYVILLE	W IH L S EY V AH L
WILSIE	W IH L S AY
WILSONDALE	W IH L S AH N D EY L
WILSONS	W IH L S AH N Z
WILSONVILLE	W IH L S AA N V AH L
WIMAUMA	W IH M AH M AH
WINBURNE	W IH N B AH R N
WINCHENDON	W IH N CH EH N D AO N
WINDBER	W IH N D B IY ER
WINDCREST	W IH N D K R EH S T
WINDEMERE	W IH N D IY M IH ER
WINDERMERE	W IH N D ER M IH ER
WINDSORVILLE	W IH N D S AO R V AH L
WINDTHORST	W IH N D TH AH R S T
WINDWOOD	W IH N D W UH D
WINDYVILLE	W IH N D AH V AH L
WINETKA	W AH N EH T AH
WINGDALE	W IH NG D EY L
WINGHAM	W IH NG HH AE M
WINGINA	W IH N JH AH N AH
WINHAM	W IH N HH AE M
WINIFREDE	W IH N AH F R IY D
WINIGAN	W IH N AH G AH N
WINLOCK	W IH N L AA K
WINNABOW	W IH N AH B OW
WINNECONNE	W IH N AH K AH N
WINNEMUCCA	W IH N AH M AH K AH
WINNETOON	W IH N AH T UW N
WINNFIELD	W IH N F IY L D
WINNSBORO	W IH N S B AH R OW
WINSIDE	W IH N S AY D
WINSTED	W IH N Z T EH D
WINTERGREEN	W IH N T ER G R IY N
WINTERPORT	W IH N T ER P OW R T
WINTERSET	W IH N T ER S EH T
WINTERSVILLE	W IH N T AH R S V AH L
WINTERVILLE	W IH N T AH R V AH L
WIOTA	W AY AH T AH
WISCASSET	W IH S AE S AH T
WISSE	W IH S
WISTER	W IH S T AH R
WISTERIA	W IH S T IY R IY AH
WITTENSVILLE	W IH T EH N S V AH L
WITTHOFF	W IH T TH AO F
WK	D AH B AH L Y UW K
WODEN	W OW D AH N
WOLBACH	W OW L B AH CH
WOLCOTTVILLE	W OW L K AA T V AH L
WOLFCREEK	W UH L F K R IY K
WOLFEBORO	W OW L F EH B AH R OW
WOLFFORTH	W UH L F ER TH
WOLSETH	W AA L Z AH TH
WOMELSDORF	W AH M EH L S D AH R F
WONEWOC	W AA N Y UW AH K
WOODACRE	W UH D EY K ER
WOODBINE	W UW D AY N
WOODBOURNE	W UW D OW R N
WOODCREST	W UH D K R EH S T
WOODCUTTERS	W UH D K AH T ER Z
WOODDALE	W UH D EY L
WOODGATE	W UH D G EY T
WOODHAVEN	W UH D HH EY V AH N
WOODINVILLE	W UW D IH N V AH L
WOODLAKE	W UH D L EY K
WOODLANE	W UH D L EY N
WOODLAWN	W UH D L AO N
WOODLEAF	W UH D L IY F
WOODLYN	W UW D L AH N
WOODLYNNE	W UW D L AH N
WOODMANSTEN	W UH D M AE N Z T EH N
WOODMERE	W UH D M IH ER
WOODPOINT	W UH D P OY N T
WOODRIDGE	W UH D R IH JH
WOODROSE	W UH D R OW Z
WOODSBORO	W UW D S B AH R OW
WOODSTON	W UH D Z T AH N
WOODSTOWN	W UH D Z T AW N
WOODSVILLE	W UW D S V AH L
WOODVALE	W UH D V EY L
WOODVIL	W UW D AH L
WOODVILLE	W UW D AH L
WOODWAY	W UH D W EY
WOODYCREST	W UH D IY K R EH S T
WOOLLUM	W UW L AH M
WOOLRICH	W UH L R IH CH
WOOLSTOCK	W UH L S T AA K
WOOLWICH	W UW L W AH CH
WOOLWORTHS	W UH L W ER TH S
WOONSOCKET	W UW N S AA K AH T
WORMLEYSBURG	W AH R M L EY Z AH R G
WORTHVILLE	W AH R TH V AH L
WPU	W P UW
WRANGLEBORO	R AE N G L EH B AH R OW
WRENS	R EH N Z
WRENSHALL	R EH N SH AH L
WRENTHAM	R EH N TH AH M
WRIGHTSBORO	R AY T S B AH R OW
WRIGHTSTOWN	R AY T S T AW N
WRIGHTSVILLE	R AY T S V AH L
WRIGHTWOOD	R AY T W UH D
WRTC	D AH B AH L Y UW AA R T IY K
WTC	D AH B AH L Y UW T IY K
WUESTER	W UW W EH S T AH R
WUK	W AH K
WURTSBORO	W AH R T S B AH R OW
WYACONDA	W AY AH K AA N D AH
WYALUSING	W AY AH L UW Z AH NG
WYANDANCH	W AY AE N D AH N CH
WYANDOTTE	W AY AE N D AH T
WYANET	W AY AH N AH T
WYCHVIEW	W IH CH V IY W
WYCK	W IH K
WYDHAM	W IH D HH AH M
WYEVILLE	W AY AH V AH L
WYLLIESBURG	W IH L IY Z AH R G
WYNANTSKILL	W AH N AE N T S AH L
WYNCOTE	W IH NG K OW T
WYNCREST	W IH NG K R AH S T
WYNDHURST	W IH N D HH AH R S T
WYNDMERE	W IH N D M AH R
WYNNEWOOD	W IH N Y UW UW D
WYNOT	W IH N AH T
WYNWOOD	W IH N W UW D
WYOLA	W AY AH L AH
WYOMISSING	W AY AH M IH S AH NG
WYONA	W AY AH N AH
WYSOX	W IH S AH K S
WYTHEVILLE	W IH TH AH V AH L
WYTOPITLOCK	W IH T AH P IH T L AH K
YACENDA	Y AH S EH N D AH
YACHATS	Y AH CH EY T S
YACOLT	Y AH K OW L T
YADKINVILLE	Y AE D K IH N V AH L
YAFA	Y AE F AH
YAKUTAT	Y AE K Y UW T AH T
YALAHA	Y AE L AH HH AH
YAMHILL	Y AE M HH AH L
YANCEYVILLE	Y AE N S EY V AH L
YANKTON	Y AE NG K T AH N
YANTACAW	Y AE N T AH K AH
YAPHANK	Y AE P HH AE NG K
YARDVILLE	Y AA R D AH L
YARMOUTH	Y AA R M AW TH
YATESVILLE	Y AH T EH Z AH L
YAWKEY	Y AO K IY
YAWPO	Y AO P OW
YAZOO	Y AA Z UW
YEAGERTOWN	Y IY JH AH R T OW N
YELLVILLE	Y EH L V AH L
YELM	Y EH L M
YEMASSEE	Y EH M AH S IY IY
YEOMALT	Y IY AH M AH L T
YERINGTON	Y AH R IH N G T AH N
YESO	Y EH S OW
YGNACIO	Y G N EY S IY OW
YMCA	Y M K AA
YONCALLA	Y AO NG K AE L AH
YORKSHIP	Y AO R K S HH IH P
YORKTOWNE	Y AO R K T OW N
YORKVILLE	Y AO R K V AH L
YOUNGSVILLE	Y AW N G S V AH L
YOUNGTOWN	Y AH NG T AW N
YOUNGWOOD	Y AH NG W UH D
YOUNTVILLE	Y AW N T V AH L
YREKA	Y R EH K AH
YSABEL	Y S AE B AH L
YSIDRO	Y S IH D R OW
YUBAS	Y UW B AH Z
YULAN	Y UH L AH N
YULEE	Y AH L IY IY
YUTAN	Y UW T AH N
YZNAGA	Y Z N AE G AH
ZAHL	Z AE L
ZALMA	Z AE L M AH
ZAMBORY	Z AE M B AH R IY
ZANESFIELD	Z AE N AH S IY L D
ZARELLI	Z AH R EH L IY
ZAVALLA	Z AH V AE L AH
ZEARING	Z IY R AH NG
ZELIENOPLE	Z IY L IY N AH P AH L
ZELLEY	Z EH L IY
ZELLWOOD	Z EH L W UW D
ZEONA	Z IY AH N AH
ZEPHYRHILLS	Z EH F AH R AH L Z
ZEREGA	Z EH R AH G AH
ZIEGLERSVILLE	Z IY G L AH R S V AH L
ZIONSVILLE	Z AY AA N S V AH L
ZIONVILLE	Z AY AA N V AH L
ZIRCONIA	Z AH R K OW N Y AH
ZOARVILLE	Z OW R V AH L
ZOLFO	Z OW L F OW
ZULCH	Z AH L CH
ZULETTE	Z UW L EH T
ZUMBROTA	Z AH M B R AH T AH
ZWINGLE	Z W IH N G AH L
ZWOLLE	Z W AA L
